3MYASTQBG7CKGRM1SSVJ3FQ3Q8YDQY	The new requirement could amount to 35 billion euros, said business daily Cinco Dias.	8	19	requirement	3	4	7
3MYASTQBG7CKGRM1SSVJ3FQ3Q8YDQY	The new requirement could amount to 35 billion euros, said business daily Cinco Dias.	74	84	Cinco Dias	1	0	1
3MYASTQBG7CKGRM1SSVJ3FQ3Q8YDQY	That is in addition to the 53.8 billion euros in provisions already demanded in a reform announced in February.	49	59	provisions	10	6	16
3MYASTQBG7CKGRM1SSVJ3FQ3Q8YDQY	That is in addition to the 53.8 billion euros in provisions already demanded in a reform announced in February.	68	76	demanded	1	2	3
3MYASTQBG7CKGRM1SSVJ3FQ3Q8YDQY	That is in addition to the 53.8 billion euros in provisions already demanded in a reform announced in February.	82	88	reform	8	3	11
3MYASTQBG7CKGRM1SSVJ3FQ3Q8YDQY	Rajoy's conservative government had instilled markets with a brief dose of confidence by stepping into Bankia, performing a U-turn on its refusal to spend public money to rescue banks.	8	20	conservative	3	5	8
3MYASTQBG7CKGRM1SSVJ3FQ3Q8YDQY	Rajoy's conservative government had instilled markets with a brief dose of confidence by stepping into Bankia, performing a U-turn on its refusal to spend public money to rescue banks.	8	31	conservative government	1	1	2
3MYASTQBG7CKGRM1SSVJ3FQ3Q8YDQY	Rajoy's conservative government had instilled markets with a brief dose of confidence by stepping into Bankia, performing a U-turn on its refusal to spend public money to rescue banks.	36	45	instilled	10	10	20
3MYASTQBG7CKGRM1SSVJ3FQ3Q8YDQY	Rajoy's conservative government had instilled markets with a brief dose of confidence by stepping into Bankia, performing a U-turn on its refusal to spend public money to rescue banks.	36	53	instilled markets	1	1	2
3MYASTQBG7CKGRM1SSVJ3FQ3Q8YDQY	Rajoy's conservative government had instilled markets with a brief dose of confidence by stepping into Bankia, performing a U-turn on its refusal to spend public money to rescue banks.	61	66	brief	0	2	2
3MYASTQBG7CKGRM1SSVJ3FQ3Q8YDQY	Rajoy's conservative government had instilled markets with a brief dose of confidence by stepping into Bankia, performing a U-turn on its refusal to spend public money to rescue banks.	61	85	brief dose of confidence	1	0	1
3MYASTQBG7CKGRM1SSVJ3FQ3Q8YDQY	Rajoy's conservative government had instilled markets with a brief dose of confidence by stepping into Bankia, performing a U-turn on its refusal to spend public money to rescue banks.	67	85	dose of confidence	1	1	2
3MYASTQBG7CKGRM1SSVJ3FQ3Q8YDQY	Rajoy's conservative government had instilled markets with a brief dose of confidence by stepping into Bankia, performing a U-turn on its refusal to spend public money to rescue banks.	75	85	confidence	0	1	1
3MYASTQBG7CKGRM1SSVJ3FQ3Q8YDQY	Rajoy's conservative government had instilled markets with a brief dose of confidence by stepping into Bankia, performing a U-turn on its refusal to spend public money to rescue banks.	89	97	stepping	2	1	3
3MYASTQBG7CKGRM1SSVJ3FQ3Q8YDQY	Rajoy's conservative government had instilled markets with a brief dose of confidence by stepping into Bankia, performing a U-turn on its refusal to spend public money to rescue banks.	124	130	U-turn	2	2	4
3MYASTQBG7CKGRM1SSVJ3FQ3Q8YDQY	Rajoy's conservative government had instilled markets with a brief dose of confidence by stepping into Bankia, performing a U-turn on its refusal to spend public money to rescue banks.	138	145	refusal	1	2	3
3MYASTQBG7CKGRM1SSVJ3FQ3Q8YDQY	Rajoy's conservative government had instilled markets with a brief dose of confidence by stepping into Bankia, performing a U-turn on its refusal to spend public money to rescue banks.	155	167	public money	1	0	1
3MYASTQBG7CKGRM1SSVJ3FQ3Q8YDQY	Rajoy's conservative government had instilled markets with a brief dose of confidence by stepping into Bankia, performing a U-turn on its refusal to spend public money to rescue banks.	171	177	rescue	0	1	1
3MYASTQBG7CKGRM1SSVJ3FQ3Q8YDQY	Rajoy's conservative government had instilled markets with a brief dose of confidence by stepping into Bankia, performing a U-turn on its refusal to spend public money to rescue banks.	171	183	rescue banks	1	1	2
3MYASTQBG7CKGRM1SSVJ3FQ3Q8YDQY	The government would take control stake by converting a state-backed loan of 4.465 billion euros ($5.8 billion) into shares in the bank's parent company, and it reportedly may boost the total investment to 7-10 billion euros.	26	39	control stake	5	0	5
3MYASTQBG7CKGRM1SSVJ3FQ3Q8YDQY	The government would take control stake by converting a state-backed loan of 4.465 billion euros ($5.8 billion) into shares in the bank's parent company, and it reportedly may boost the total investment to 7-10 billion euros.	34	39	stake	2	3	5
3MYASTQBG7CKGRM1SSVJ3FQ3Q8YDQY	The government would take control stake by converting a state-backed loan of 4.465 billion euros ($5.8 billion) into shares in the bank's parent company, and it reportedly may boost the total investment to 7-10 billion euros.	43	53	converting	2	2	4
3MYASTQBG7CKGRM1SSVJ3FQ3Q8YDQY	The government would take control stake by converting a state-backed loan of 4.465 billion euros ($5.8 billion) into shares in the bank's parent company, and it reportedly may boost the total investment to 7-10 billion euros.	56	68	state-backed	1	1	2
3MYASTQBG7CKGRM1SSVJ3FQ3Q8YDQY	The government would take control stake by converting a state-backed loan of 4.465 billion euros ($5.8 billion) into shares in the bank's parent company, and it reportedly may boost the total investment to 7-10 billion euros.	56	73	state-backed loan	4	1	5
3MYASTQBG7CKGRM1SSVJ3FQ3Q8YDQY	The government would take control stake by converting a state-backed loan of 4.465 billion euros ($5.8 billion) into shares in the bank's parent company, and it reportedly may boost the total investment to 7-10 billion euros.	117	123	shares	1	0	1
3MYASTQBG7CKGRM1SSVJ3FQ3Q8YDQY	The government would take control stake by converting a state-backed loan of 4.465 billion euros ($5.8 billion) into shares in the bank's parent company, and it reportedly may boost the total investment to 7-10 billion euros.	138	152	parent company	3	0	3
3MYASTQBG7CKGRM1SSVJ3FQ3Q8YDQY	The government would take control stake by converting a state-backed loan of 4.465 billion euros ($5.8 billion) into shares in the bank's parent company, and it reportedly may boost the total investment to 7-10 billion euros.	161	171	reportedly	1	0	1
3MYASTQBG7CKGRM1SSVJ3FQ3Q8YDQY	The government would take control stake by converting a state-backed loan of 4.465 billion euros ($5.8 billion) into shares in the bank's parent company, and it reportedly may boost the total investment to 7-10 billion euros.	176	181	boost	3	3	6
3MYASTQBG7CKGRM1SSVJ3FQ3Q8YDQY	The government would take control stake by converting a state-backed loan of 4.465 billion euros ($5.8 billion) into shares in the bank's parent company, and it reportedly may boost the total investment to 7-10 billion euros.	192	202	investment	1	0	1
3MYASTQBG7CKGRM1SSVJ3FQ3Q8YDQY	But the transaction, announced late Wednesday, has also refocussed attention on the Spanish banks' problems, and the potential costs to a conservative government determined to slash spending.	8	19	transaction	4	3	7
3MYASTQBG7CKGRM1SSVJ3FQ3Q8YDQY	But the transaction, announced late Wednesday, has also refocussed attention on the Spanish banks' problems, and the potential costs to a conservative government determined to slash spending.	56	66	refocussed	10	6	16
3MYASTQBG7CKGRM1SSVJ3FQ3Q8YDQY	But the transaction, announced late Wednesday, has also refocussed attention on the Spanish banks' problems, and the potential costs to a conservative government determined to slash spending.	56	76	refocussed attention	1	0	1
3MYASTQBG7CKGRM1SSVJ3FQ3Q8YDQY	But the transaction, announced late Wednesday, has also refocussed attention on the Spanish banks' problems, and the potential costs to a conservative government determined to slash spending.	117	126	potential	3	2	5
3MYASTQBG7CKGRM1SSVJ3FQ3Q8YDQY	But the transaction, announced late Wednesday, has also refocussed attention on the Spanish banks' problems, and the potential costs to a conservative government determined to slash spending.	117	132	potential costs	0	1	1
3MYASTQBG7CKGRM1SSVJ3FQ3Q8YDQY	But the transaction, announced late Wednesday, has also refocussed attention on the Spanish banks' problems, and the potential costs to a conservative government determined to slash spending.	138	150	conservative	2	0	2
3MYASTQBG7CKGRM1SSVJ3FQ3Q8YDQY	But the transaction, announced late Wednesday, has also refocussed attention on the Spanish banks' problems, and the potential costs to a conservative government determined to slash spending.	162	172	determined	0	2	2
3MYASTQBG7CKGRM1SSVJ3FQ3Q8YDQY	But the transaction, announced late Wednesday, has also refocussed attention on the Spanish banks' problems, and the potential costs to a conservative government determined to slash spending.	176	181	slash	4	8	12
3MYASTQBG7CKGRM1SSVJ3FQ3Q8YDQY	But the transaction, announced late Wednesday, has also refocussed attention on the Spanish banks' problems, and the potential costs to a conservative government determined to slash spending.	176	190	slash spending	2	1	3
32XN26MTXZKFQA5UOBZS7M7QMD2L0O	By late morning, Santander, the eurozone's biggest bank by capital, had slumped 2.97 percent to 4.774 euros, number-two BBVA slid 2.62 percent to 5.171 euros and Banco Popular skidded 3.75 percent to 2.08 euros.	17	26	Santander	1	0	1
32XN26MTXZKFQA5UOBZS7M7QMD2L0O	By late morning, Santander, the eurozone's biggest bank by capital, had slumped 2.97 percent to 4.774 euros, number-two BBVA slid 2.62 percent to 5.171 euros and Banco Popular skidded 3.75 percent to 2.08 euros.	32	41	eurozones	6	1	7
32XN26MTXZKFQA5UOBZS7M7QMD2L0O	By late morning, Santander, the eurozone's biggest bank by capital, had slumped 2.97 percent to 4.774 euros, number-two BBVA slid 2.62 percent to 5.171 euros and Banco Popular skidded 3.75 percent to 2.08 euros.	56	66	by capital	1	0	1
32XN26MTXZKFQA5UOBZS7M7QMD2L0O	By late morning, Santander, the eurozone's biggest bank by capital, had slumped 2.97 percent to 4.774 euros, number-two BBVA slid 2.62 percent to 5.171 euros and Banco Popular skidded 3.75 percent to 2.08 euros.	59	66	capital	1	0	1
32XN26MTXZKFQA5UOBZS7M7QMD2L0O	By late morning, Santander, the eurozone's biggest bank by capital, had slumped 2.97 percent to 4.774 euros, number-two BBVA slid 2.62 percent to 5.171 euros and Banco Popular skidded 3.75 percent to 2.08 euros.	72	79	slumped	6	10	16
32XN26MTXZKFQA5UOBZS7M7QMD2L0O	By late morning, Santander, the eurozone's biggest bank by capital, had slumped 2.97 percent to 4.774 euros, number-two BBVA slid 2.62 percent to 5.171 euros and Banco Popular skidded 3.75 percent to 2.08 euros.	109	124	number-two BBVA	2	0	2
32XN26MTXZKFQA5UOBZS7M7QMD2L0O	By late morning, Santander, the eurozone's biggest bank by capital, had slumped 2.97 percent to 4.774 euros, number-two BBVA slid 2.62 percent to 5.171 euros and Banco Popular skidded 3.75 percent to 2.08 euros.	120	129	BBVA slid	1	0	1
32XN26MTXZKFQA5UOBZS7M7QMD2L0O	By late morning, Santander, the eurozone's biggest bank by capital, had slumped 2.97 percent to 4.774 euros, number-two BBVA slid 2.62 percent to 5.171 euros and Banco Popular skidded 3.75 percent to 2.08 euros.	125	129	slid	0	1	1
32XN26MTXZKFQA5UOBZS7M7QMD2L0O	By late morning, Santander, the eurozone's biggest bank by capital, had slumped 2.97 percent to 4.774 euros, number-two BBVA slid 2.62 percent to 5.171 euros and Banco Popular skidded 3.75 percent to 2.08 euros.	162	175	Banco Popular	1	0	1
32XN26MTXZKFQA5UOBZS7M7QMD2L0O	By late morning, Santander, the eurozone's biggest bank by capital, had slumped 2.97 percent to 4.774 euros, number-two BBVA slid 2.62 percent to 5.171 euros and Banco Popular skidded 3.75 percent to 2.08 euros.	176	183	skidded	5	10	15
32XN26MTXZKFQA5UOBZS7M7QMD2L0O	Bankia, in which the state is taking a 45-percent stake as a crisis measure to save it from crippling bad loans, fell 2.14 percent to 2.06 euros, bringing losses this week to 16.26 percent.	0	6	Bankia	1	0	1
32XN26MTXZKFQA5UOBZS7M7QMD2L0O	Bankia, in which the state is taking a 45-percent stake as a crisis measure to save it from crippling bad loans, fell 2.14 percent to 2.06 euros, bringing losses this week to 16.26 percent.	50	55	stake	2	3	5
32XN26MTXZKFQA5UOBZS7M7QMD2L0O	Bankia, in which the state is taking a 45-percent stake as a crisis measure to save it from crippling bad loans, fell 2.14 percent to 2.06 euros, bringing losses this week to 16.26 percent.	61	67	crisis	0	3	3
32XN26MTXZKFQA5UOBZS7M7QMD2L0O	Bankia, in which the state is taking a 45-percent stake as a crisis measure to save it from crippling bad loans, fell 2.14 percent to 2.06 euros, bringing losses this week to 16.26 percent.	61	75	crisis measure	5	1	6
32XN26MTXZKFQA5UOBZS7M7QMD2L0O	Bankia, in which the state is taking a 45-percent stake as a crisis measure to save it from crippling bad loans, fell 2.14 percent to 2.06 euros, bringing losses this week to 16.26 percent.	68	75	measure	1	0	1
32XN26MTXZKFQA5UOBZS7M7QMD2L0O	Bankia, in which the state is taking a 45-percent stake as a crisis measure to save it from crippling bad loans, fell 2.14 percent to 2.06 euros, bringing losses this week to 16.26 percent.	92	101	crippling	9	10	19
32XN26MTXZKFQA5UOBZS7M7QMD2L0O	Bankia, in which the state is taking a 45-percent stake as a crisis measure to save it from crippling bad loans, fell 2.14 percent to 2.06 euros, bringing losses this week to 16.26 percent.	92	111	crippling bad loans	1	0	1
32XN26MTXZKFQA5UOBZS7M7QMD2L0O	Created from a merger of seven savings banks, Bankia had 37.5 billion euros in exposure to the property sector at the end of 2011, of which 31.8 billion euros were classed as problematic.	15	21	merger	8	9	17
32XN26MTXZKFQA5UOBZS7M7QMD2L0O	Created from a merger of seven savings banks, Bankia had 37.5 billion euros in exposure to the property sector at the end of 2011, of which 31.8 billion euros were classed as problematic.	25	44	seven savings banks	1	0	1
32XN26MTXZKFQA5UOBZS7M7QMD2L0O	Created from a merger of seven savings banks, Bankia had 37.5 billion euros in exposure to the property sector at the end of 2011, of which 31.8 billion euros were classed as problematic.	79	87	exposure	4	8	12
32XN26MTXZKFQA5UOBZS7M7QMD2L0O	Created from a merger of seven savings banks, Bankia had 37.5 billion euros in exposure to the property sector at the end of 2011, of which 31.8 billion euros were classed as problematic.	79	110	exposure to the property sector	1	1	2
32XN26MTXZKFQA5UOBZS7M7QMD2L0O	Created from a merger of seven savings banks, Bankia had 37.5 billion euros in exposure to the property sector at the end of 2011, of which 31.8 billion euros were classed as problematic.	95	110	property sector	4	0	4
32XN26MTXZKFQA5UOBZS7M7QMD2L0O	Created from a merger of seven savings banks, Bankia had 37.5 billion euros in exposure to the property sector at the end of 2011, of which 31.8 billion euros were classed as problematic.	104	110	sector	1	0	1
32XN26MTXZKFQA5UOBZS7M7QMD2L0O	Created from a merger of seven savings banks, Bankia had 37.5 billion euros in exposure to the property sector at the end of 2011, of which 31.8 billion euros were classed as problematic.	164	171	classed	1	1	2
32XN26MTXZKFQA5UOBZS7M7QMD2L0O	Created from a merger of seven savings banks, Bankia had 37.5 billion euros in exposure to the property sector at the end of 2011, of which 31.8 billion euros were classed as problematic.	164	186	classed as problematic	1	0	1
32XN26MTXZKFQA5UOBZS7M7QMD2L0O	Created from a merger of seven savings banks, Bankia had 37.5 billion euros in exposure to the property sector at the end of 2011, of which 31.8 billion euros were classed as problematic.	175	186	problematic	6	8	14
32XN26MTXZKFQA5UOBZS7M7QMD2L0O	But the hangover from the property party extends across the financial sector.	8	16	hangover	8	10	18
32XN26MTXZKFQA5UOBZS7M7QMD2L0O	But the hangover from the property party extends across the financial sector.	26	40	property party	2	0	2
32XN26MTXZKFQA5UOBZS7M7QMD2L0O	But the hangover from the property party extends across the financial sector.	41	48	extends	1	1	2
32XN26MTXZKFQA5UOBZS7M7QMD2L0O	But the hangover from the property party extends across the financial sector.	60	76	financial sector	2	0	2
32XN26MTXZKFQA5UOBZS7M7QMD2L0O	But the hangover from the property party extends across the financial sector.	70	76	sector	3	0	3
32XN26MTXZKFQA5UOBZS7M7QMD2L0O	Bank of Spain figures show commercial banks held problematic real estate assets including loans and seized property of 184 billion euros, 60 percent of their property portfolio at the end of 2011.	49	60	problematic	4	1	5
32XN26MTXZKFQA5UOBZS7M7QMD2L0O	Bank of Spain figures show commercial banks held problematic real estate assets including loans and seized property of 184 billion euros, 60 percent of their property portfolio at the end of 2011.	49	79	problematic real estate assets	1	0	1
32XN26MTXZKFQA5UOBZS7M7QMD2L0O	Bank of Spain figures show commercial banks held problematic real estate assets including loans and seized property of 184 billion euros, 60 percent of their property portfolio at the end of 2011.	61	79	real estate assets	2	0	2
32XN26MTXZKFQA5UOBZS7M7QMD2L0O	Bank of Spain figures show commercial banks held problematic real estate assets including loans and seized property of 184 billion euros, 60 percent of their property portfolio at the end of 2011.	73	79	assets	1	2	3
32XN26MTXZKFQA5UOBZS7M7QMD2L0O	Bank of Spain figures show commercial banks held problematic real estate assets including loans and seized property of 184 billion euros, 60 percent of their property portfolio at the end of 2011.	100	106	seized	5	9	14
32XN26MTXZKFQA5UOBZS7M7QMD2L0O	Bank of Spain figures show commercial banks held problematic real estate assets including loans and seized property of 184 billion euros, 60 percent of their property portfolio at the end of 2011.	100	115	seized property	0	1	1
32XN26MTXZKFQA5UOBZS7M7QMD2L0O	Bank of Spain figures show commercial banks held problematic real estate assets including loans and seized property of 184 billion euros, 60 percent of their property portfolio at the end of 2011.	158	176	property portfolio	6	1	7
32XN26MTXZKFQA5UOBZS7M7QMD2L0O	Bank of Spain figures show commercial banks held problematic real estate assets including loans and seized property of 184 billion euros, 60 percent of their property portfolio at the end of 2011.	167	176	portfolio	4	6	10
3D3B8GE892SNDP85GZBSHEH3V409PG	On Facebook, more than 10,000 people signed up to a page announcing an opposition rally for Saturday.	57	67	announcing	4	3	7
3D3B8GE892SNDP85GZBSHEH3V409PG	On Facebook, more than 10,000 people signed up to a page announcing an opposition rally for Saturday.	71	81	opposition	4	0	4
3D3B8GE892SNDP85GZBSHEH3V409PG	On Facebook, more than 10,000 people signed up to a page announcing an opposition rally for Saturday.	71	87	opposition rally	6	2	8
3D3B8GE892SNDP85GZBSHEH3V409PG	On Facebook, more than 10,000 people signed up to a page announcing an opposition rally for Saturday.	82	87	rally	0	2	2
3D3B8GE892SNDP85GZBSHEH3V409PG	Authorities said on Tuesday at least 51,500 police officers and 2,000 interior ministry troops have been deployed in Moscow since the election.	0	11	Authorities	1	4	5
3D3B8GE892SNDP85GZBSHEH3V409PG	Authorities said on Tuesday at least 51,500 police officers and 2,000 interior ministry troops have been deployed in Moscow since the election.	70	78	interior	1	2	3
3D3B8GE892SNDP85GZBSHEH3V409PG	Authorities said on Tuesday at least 51,500 police officers and 2,000 interior ministry troops have been deployed in Moscow since the election.	70	87	interior ministry	3	2	5
3D3B8GE892SNDP85GZBSHEH3V409PG	Authorities said on Tuesday at least 51,500 police officers and 2,000 interior ministry troops have been deployed in Moscow since the election.	70	94	interior ministry troops	3	0	3
3D3B8GE892SNDP85GZBSHEH3V409PG	Authorities said on Tuesday at least 51,500 police officers and 2,000 interior ministry troops have been deployed in Moscow since the election.	88	94	troops	0	1	1
3D3B8GE892SNDP85GZBSHEH3V409PG	Authorities said on Tuesday at least 51,500 police officers and 2,000 interior ministry troops have been deployed in Moscow since the election.	105	113	deployed	7	10	17
3D3B8GE892SNDP85GZBSHEH3V409PG	At least 300 people were detained by police at a protest in central Moscow on Tuesday night that included flare-type fireworks thrown at a group of pro-Kremlin youth, said a city police spokesman, Maxim Kolosvetov.	25	33	detained	9	8	17
3D3B8GE892SNDP85GZBSHEH3V409PG	At least 300 people were detained by police at a protest in central Moscow on Tuesday night that included flare-type fireworks thrown at a group of pro-Kremlin youth, said a city police spokesman, Maxim Kolosvetov.	49	56	protest	0	4	4
3D3B8GE892SNDP85GZBSHEH3V409PG	At least 300 people were detained by police at a protest in central Moscow on Tuesday night that included flare-type fireworks thrown at a group of pro-Kremlin youth, said a city police spokesman, Maxim Kolosvetov.	97	105	included	0	1	1
3D3B8GE892SNDP85GZBSHEH3V409PG	At least 300 people were detained by police at a protest in central Moscow on Tuesday night that included flare-type fireworks thrown at a group of pro-Kremlin youth, said a city police spokesman, Maxim Kolosvetov.	106	116	flare-type	5	5	10
3D3B8GE892SNDP85GZBSHEH3V409PG	At least 300 people were detained by police at a protest in central Moscow on Tuesday night that included flare-type fireworks thrown at a group of pro-Kremlin youth, said a city police spokesman, Maxim Kolosvetov.	106	126	flare-type fireworks	4	3	7
3D3B8GE892SNDP85GZBSHEH3V409PG	At least 300 people were detained by police at a protest in central Moscow on Tuesday night that included flare-type fireworks thrown at a group of pro-Kremlin youth, said a city police spokesman, Maxim Kolosvetov.	117	126	fireworks	1	1	2
3D3B8GE892SNDP85GZBSHEH3V409PG	At least 300 people were detained by police at a protest in central Moscow on Tuesday night that included flare-type fireworks thrown at a group of pro-Kremlin youth, said a city police spokesman, Maxim Kolosvetov.	148	159	pro-Kremlin	2	0	2
3D3B8GE892SNDP85GZBSHEH3V409PG	At least 300 people were detained by police at a protest in central Moscow on Tuesday night that included flare-type fireworks thrown at a group of pro-Kremlin youth, said a city police spokesman, Maxim Kolosvetov.	148	165	pro-Kremlin youth	1	2	3
3D3B8GE892SNDP85GZBSHEH3V409PG	At least 300 people were detained by police at a protest in central Moscow on Tuesday night that included flare-type fireworks thrown at a group of pro-Kremlin youth, said a city police spokesman, Maxim Kolosvetov.	186	195	spokesman	1	3	4
3D3B8GE892SNDP85GZBSHEH3V409PG	Russian news agencies reported about demonstrators d200 were arrested at a similar attempt to hold an unsanctioned rally in St Petersburg and another 25 in the southern city of Rostov-on-Don.	37	50	demonstrators	8	6	14
3D3B8GE892SNDP85GZBSHEH3V409PG	Russian news agencies reported about demonstrators d200 were arrested at a similar attempt to hold an unsanctioned rally in St Petersburg and another 25 in the southern city of Rostov-on-Don.	83	90	attempt	0	1	1
3D3B8GE892SNDP85GZBSHEH3V409PG	Russian news agencies reported about demonstrators d200 were arrested at a similar attempt to hold an unsanctioned rally in St Petersburg and another 25 in the southern city of Rostov-on-Don.	102	114	unsanctioned	10	8	18
3D3B8GE892SNDP85GZBSHEH3V409PG	Russian news agencies reported about demonstrators d200 were arrested at a similar attempt to hold an unsanctioned rally in St Petersburg and another 25 in the southern city of Rostov-on-Don.	102	120	unsanctioned rally	4	2	6
3D3B8GE892SNDP85GZBSHEH3V409PG	Russian news agencies reported about demonstrators d200 were arrested at a similar attempt to hold an unsanctioned rally in St Petersburg and another 25 in the southern city of Rostov-on-Don.	115	120	rally	0	2	2
3D3B8GE892SNDP85GZBSHEH3V409PG	The Moscow protest ended after nearly four hours; the other rallies were broken up by police.	11	18	protest	1	1	2
3D3B8GE892SNDP85GZBSHEH3V409PG	The Moscow protest ended after nearly four hours; the other rallies were broken up by police.	60	67	rallies	2	2	4
3D3B8GE892SNDP85GZBSHEH3V409PG	The Moscow protest ended after nearly four hours; the other rallies were broken up by police.	73	82	broken up	0	1	1
3GONHBMNHVZWYDT5SHDZDYP141QMZM	The agreement was long sought by the U.S.-backed government of Afghan President Hamid Karzai, the perpetually skittish leader who has publicly voiced fears of what would befall his country if the United States quickly packed up and left.	4	13	agreement	0	1	1
3GONHBMNHVZWYDT5SHDZDYP141QMZM	The agreement was long sought by the U.S.-backed government of Afghan President Hamid Karzai, the perpetually skittish leader who has publicly voiced fears of what would befall his country if the United States quickly packed up and left.	18	29	long sought	1	1	2
3GONHBMNHVZWYDT5SHDZDYP141QMZM	The agreement was long sought by the U.S.-backed government of Afghan President Hamid Karzai, the perpetually skittish leader who has publicly voiced fears of what would befall his country if the United States quickly packed up and left.	23	29	sought	6	7	13
3GONHBMNHVZWYDT5SHDZDYP141QMZM	The agreement was long sought by the U.S.-backed government of Afghan President Hamid Karzai, the perpetually skittish leader who has publicly voiced fears of what would befall his country if the United States quickly packed up and left.	37	48	U.S.-backed	1	0	1
3GONHBMNHVZWYDT5SHDZDYP141QMZM	The agreement was long sought by the U.S.-backed government of Afghan President Hamid Karzai, the perpetually skittish leader who has publicly voiced fears of what would befall his country if the United States quickly packed up and left.	98	109	perpetually	9	5	14
3GONHBMNHVZWYDT5SHDZDYP141QMZM	The agreement was long sought by the U.S.-backed government of Afghan President Hamid Karzai, the perpetually skittish leader who has publicly voiced fears of what would befall his country if the United States quickly packed up and left.	98	118	perpetually skittish	5	5	10
3GONHBMNHVZWYDT5SHDZDYP141QMZM	The agreement was long sought by the U.S.-backed government of Afghan President Hamid Karzai, the perpetually skittish leader who has publicly voiced fears of what would befall his country if the United States quickly packed up and left.	110	118	skittish	10	7	17
3GONHBMNHVZWYDT5SHDZDYP141QMZM	The agreement was long sought by the U.S.-backed government of Afghan President Hamid Karzai, the perpetually skittish leader who has publicly voiced fears of what would befall his country if the United States quickly packed up and left.	110	125	skittish leader	0	1	1
3GONHBMNHVZWYDT5SHDZDYP141QMZM	The agreement was long sought by the U.S.-backed government of Afghan President Hamid Karzai, the perpetually skittish leader who has publicly voiced fears of what would befall his country if the United States quickly packed up and left.	134	142	publicly	1	1	2
3GONHBMNHVZWYDT5SHDZDYP141QMZM	The agreement was long sought by the U.S.-backed government of Afghan President Hamid Karzai, the perpetually skittish leader who has publicly voiced fears of what would befall his country if the United States quickly packed up and left.	134	149	publicly voiced	0	1	1
3GONHBMNHVZWYDT5SHDZDYP141QMZM	The agreement was long sought by the U.S.-backed government of Afghan President Hamid Karzai, the perpetually skittish leader who has publicly voiced fears of what would befall his country if the United States quickly packed up and left.	143	149	voiced	1	0	1
3GONHBMNHVZWYDT5SHDZDYP141QMZM	The agreement was long sought by the U.S.-backed government of Afghan President Hamid Karzai, the perpetually skittish leader who has publicly voiced fears of what would befall his country if the United States quickly packed up and left.	170	176	befall	10	10	20
3GONHBMNHVZWYDT5SHDZDYP141QMZM	"I recognize that many Americans are tired of war," Obama said in the speech.	3	12	recognize	3	3	6
3GONHBMNHVZWYDT5SHDZDYP141QMZM	"But we must finish the job we started in Afghanistan and end this war responsibly."	71	82	responsibly	2	2	4
3GONHBMNHVZWYDT5SHDZDYP141QMZM	The larger rationale of the agreement was to reassure Afghan leaders that the United States would not repeat the mistake it made following the Soviet withdrawal from Afghanistan in 1989.	11	20	rationale	10	9	19
3GONHBMNHVZWYDT5SHDZDYP141QMZM	The larger rationale of the agreement was to reassure Afghan leaders that the United States would not repeat the mistake it made following the Soviet withdrawal from Afghanistan in 1989.	45	53	reassure	5	5	10
3GONHBMNHVZWYDT5SHDZDYP141QMZM	The larger rationale of the agreement was to reassure Afghan leaders that the United States would not repeat the mistake it made following the Soviet withdrawal from Afghanistan in 1989.	143	160	Soviet withdrawal	1	0	1
3GONHBMNHVZWYDT5SHDZDYP141QMZM	The larger rationale of the agreement was to reassure Afghan leaders that the United States would not repeat the mistake it made following the Soviet withdrawal from Afghanistan in 1989.	150	160	withdrawal	5	4	9
3GONHBMNHVZWYDT5SHDZDYP141QMZM	Then, Washington withdrew support for anti-Soviet militia forces in Afghanistan and set the stage for Taliban rule.	17	25	withdrew	4	3	7
3GONHBMNHVZWYDT5SHDZDYP141QMZM	Then, Washington withdrew support for anti-Soviet militia forces in Afghanistan and set the stage for Taliban rule.	38	49	anti-Soviet	0	1	1
3GONHBMNHVZWYDT5SHDZDYP141QMZM	Then, Washington withdrew support for anti-Soviet militia forces in Afghanistan and set the stage for Taliban rule.	38	64	anti-Soviet militia forces	1	2	3
3GONHBMNHVZWYDT5SHDZDYP141QMZM	Then, Washington withdrew support for anti-Soviet militia forces in Afghanistan and set the stage for Taliban rule.	50	57	militia	3	1	4
3GONHBMNHVZWYDT5SHDZDYP141QMZM	Then, Washington withdrew support for anti-Soviet militia forces in Afghanistan and set the stage for Taliban rule.	50	64	militia forces	3	1	4
3GONHBMNHVZWYDT5SHDZDYP141QMZM	Then, Washington withdrew support for anti-Soviet militia forces in Afghanistan and set the stage for Taliban rule.	92	97	stage	1	0	1
3GONHBMNHVZWYDT5SHDZDYP141QMZM	The Taliban then allowed al-Qaida to use the country to plan the terror attacks of Sept. 11, 2001.	4	11	Taliban	1	0	1
3GONHBMNHVZWYDT5SHDZDYP141QMZM	The Taliban then allowed al-Qaida to use the country to plan the terror attacks of Sept. 11, 2001.	17	24	allowed	0	1	1
3YLTXLH3DF7GSVQOEBZKUVFREH8PHM	Also Sunday, two Turkish journalists who had been detained in Syria for two months arrived in Istanbul on a plane from Iran after that country helped negotiate their release by Syrian authorities.	17	24	Turkish	1	0	1
3YLTXLH3DF7GSVQOEBZKUVFREH8PHM	Also Sunday, two Turkish journalists who had been detained in Syria for two months arrived in Istanbul on a plane from Iran after that country helped negotiate their release by Syrian authorities.	25	36	journalists	2	0	2
3YLTXLH3DF7GSVQOEBZKUVFREH8PHM	Also Sunday, two Turkish journalists who had been detained in Syria for two months arrived in Istanbul on a plane from Iran after that country helped negotiate their release by Syrian authorities.	50	58	detained	10	9	19
3YLTXLH3DF7GSVQOEBZKUVFREH8PHM	Also Sunday, two Turkish journalists who had been detained in Syria for two months arrived in Istanbul on a plane from Iran after that country helped negotiate their release by Syrian authorities.	150	159	negotiate	10	10	20
3YLTXLH3DF7GSVQOEBZKUVFREH8PHM	Also Sunday, two Turkish journalists who had been detained in Syria for two months arrived in Istanbul on a plane from Iran after that country helped negotiate their release by Syrian authorities.	150	173	negotiate their release	1	0	1
3YLTXLH3DF7GSVQOEBZKUVFREH8PHM	Also Sunday, two Turkish journalists who had been detained in Syria for two months arrived in Istanbul on a plane from Iran after that country helped negotiate their release by Syrian authorities.	166	173	release	1	2	3
3YLTXLH3DF7GSVQOEBZKUVFREH8PHM	Also Sunday, two Turkish journalists who had been detained in Syria for two months arrived in Istanbul on a plane from Iran after that country helped negotiate their release by Syrian authorities.	184	195	authorities	0	2	2
3YLTXLH3DF7GSVQOEBZKUVFREH8PHM	Journalists Adem Ozkose and Hamit Coskun were abducted by militiamen who had blocked a road and were stopping cars and abducting passengers, Ozkose told reporters in Istanbul on Sunday.	46	54	abducted	9	9	18
3YLTXLH3DF7GSVQOEBZKUVFREH8PHM	Journalists Adem Ozkose and Hamit Coskun were abducted by militiamen who had blocked a road and were stopping cars and abducting passengers, Ozkose told reporters in Istanbul on Sunday.	58	68	militiamen	10	4	14
3YLTXLH3DF7GSVQOEBZKUVFREH8PHM	Journalists Adem Ozkose and Hamit Coskun were abducted by militiamen who had blocked a road and were stopping cars and abducting passengers, Ozkose told reporters in Istanbul on Sunday.	77	84	blocked	1	1	2
3YLTXLH3DF7GSVQOEBZKUVFREH8PHM	Journalists Adem Ozkose and Hamit Coskun were abducted by militiamen who had blocked a road and were stopping cars and abducting passengers, Ozkose told reporters in Istanbul on Sunday.	119	128	abducting	9	5	14
3YLTXLH3DF7GSVQOEBZKUVFREH8PHM	Journalists Adem Ozkose and Hamit Coskun were abducted by militiamen who had blocked a road and were stopping cars and abducting passengers, Ozkose told reporters in Istanbul on Sunday.	119	139	abducting passengers	2	2	4
3YLTXLH3DF7GSVQOEBZKUVFREH8PHM	Journalists Adem Ozkose and Hamit Coskun were abducted by militiamen who had blocked a road and were stopping cars and abducting passengers, Ozkose told reporters in Istanbul on Sunday.	153	162	reporters	1	0	1
3YLTXLH3DF7GSVQOEBZKUVFREH8PHM	He and Coskun were later held separately at a prison in Damascus, where they slept on a concrete floor, had no sunlight and lost track of the days.	25	40	held separately	0	1	1
3YLTXLH3DF7GSVQOEBZKUVFREH8PHM	He and Coskun were later held separately at a prison in Damascus, where they slept on a concrete floor, had no sunlight and lost track of the days.	30	40	separately	2	1	3
3YLTXLH3DF7GSVQOEBZKUVFREH8PHM	He and Coskun were later held separately at a prison in Damascus, where they slept on a concrete floor, had no sunlight and lost track of the days.	46	52	prison	0	1	1
3YLTXLH3DF7GSVQOEBZKUVFREH8PHM	He and Coskun were later held separately at a prison in Damascus, where they slept on a concrete floor, had no sunlight and lost track of the days.	77	82	slept	0	2	2
3YLTXLH3DF7GSVQOEBZKUVFREH8PHM	He and Coskun were later held separately at a prison in Damascus, where they slept on a concrete floor, had no sunlight and lost track of the days.	88	96	concrete	1	3	4
3YLTXLH3DF7GSVQOEBZKUVFREH8PHM	He and Coskun were later held separately at a prison in Damascus, where they slept on a concrete floor, had no sunlight and lost track of the days.	88	102	concrete floor	0	1	1
3YLTXLH3DF7GSVQOEBZKUVFREH8PHM	He and Coskun were later held separately at a prison in Damascus, where they slept on a concrete floor, had no sunlight and lost track of the days.	124	134	lost track	0	2	2
3YLTXLH3DF7GSVQOEBZKUVFREH8PHM	He and Coskun were later held separately at a prison in Damascus, where they slept on a concrete floor, had no sunlight and lost track of the days.	124	146	lost track of the days	2	1	3
3YLTXLH3DF7GSVQOEBZKUVFREH8PHM	It made me appreciate freedom.	11	21	appreciate	9	7	16
3YLTXLH3DF7GSVQOEBZKUVFREH8PHM	It made me appreciate freedom.	11	29	appreciate freedom	0	1	1
3BO3NEOQM0I91MV6VAZ84CRBF8NAIK	Google's relations with China have been strained since it moved its search engine out of the country two years ago in a dispute over censorship and security.	9	18	relations	3	0	3
3BO3NEOQM0I91MV6VAZ84CRBF8NAIK	Google's relations with China have been strained since it moved its search engine out of the country two years ago in a dispute over censorship and security.	40	48	strained	8	10	18
3BO3NEOQM0I91MV6VAZ84CRBF8NAIK	Google's relations with China have been strained since it moved its search engine out of the country two years ago in a dispute over censorship and security.	68	81	search engine	5	0	5
3BO3NEOQM0I91MV6VAZ84CRBF8NAIK	Google's relations with China have been strained since it moved its search engine out of the country two years ago in a dispute over censorship and security.	120	127	dispute	4	5	9
3BO3NEOQM0I91MV6VAZ84CRBF8NAIK	Google's relations with China have been strained since it moved its search engine out of the country two years ago in a dispute over censorship and security.	120	156	dispute over censorship and security	1	0	1
3BO3NEOQM0I91MV6VAZ84CRBF8NAIK	Google's relations with China have been strained since it moved its search engine out of the country two years ago in a dispute over censorship and security.	133	143	censorship	10	10	20
3BO3NEOQM0I91MV6VAZ84CRBF8NAIK	Google's relations with China have been strained since it moved its search engine out of the country two years ago in a dispute over censorship and security.	148	156	security	1	0	1
3BO3NEOQM0I91MV6VAZ84CRBF8NAIK	Google spokeswoman Niki Fenwick says the Chinese government cleared the deal on Saturday.	7	18	spokeswoman	5	2	7
3BO3NEOQM0I91MV6VAZ84CRBF8NAIK	Google spokeswoman Niki Fenwick says the Chinese government cleared the deal on Saturday.	60	67	cleared	0	1	1
3BO3NEOQM0I91MV6VAZ84CRBF8NAIK	The deal allows Google to expand into manufacturing phones, tablet computers and other consumer devices for the first time.	38	51	manufacturing	5	3	8
3BO3NEOQM0I91MV6VAZ84CRBF8NAIK	The deal allows Google to expand into manufacturing phones, tablet computers and other consumer devices for the first time.	60	76	tablet computers	0	1	1
3BO3NEOQM0I91MV6VAZ84CRBF8NAIK	The deal allows Google to expand into manufacturing phones, tablet computers and other consumer devices for the first time.	87	95	consumer	3	0	3
3BO3NEOQM0I91MV6VAZ84CRBF8NAIK	The deal allows Google to expand into manufacturing phones, tablet computers and other consumer devices for the first time.	87	103	consumer devices	3	3	6
3BO3NEOQM0I91MV6VAZ84CRBF8NAIK	The deal allows Google to expand into manufacturing phones, tablet computers and other consumer devices for the first time.	96	103	devices	0	1	1
3BO3NEOQM0I91MV6VAZ84CRBF8NAIK	Google also gets access to more than 17,000 Motorola patents.	17	23	access	0	3	3
3BO3NEOQM0I91MV6VAZ84CRBF8NAIK	Google also gets access to more than 17,000 Motorola patents.	44	52	Motorola	1	0	1
3BO3NEOQM0I91MV6VAZ84CRBF8NAIK	Google also gets access to more than 17,000 Motorola patents.	53	60	patents	7	2	9
3BO3NEOQM0I91MV6VAZ84CRBF8NAIK	Airport officials say that Israel's ambassador to Egypt has returned to Cairo after he and other embassy staffers fled on military planes when thousands of angry Egyptians attacked the embassy in September.	0	17	Airport officials	1	0	1
3BO3NEOQM0I91MV6VAZ84CRBF8NAIK	Airport officials say that Israel's ambassador to Egypt has returned to Cairo after he and other embassy staffers fled on military planes when thousands of angry Egyptians attacked the embassy in September.	36	46	ambassador	5	4	9
3BO3NEOQM0I91MV6VAZ84CRBF8NAIK	Airport officials say that Israel's ambassador to Egypt has returned to Cairo after he and other embassy staffers fled on military planes when thousands of angry Egyptians attacked the embassy in September.	97	104	embassy	1	2	3
3BO3NEOQM0I91MV6VAZ84CRBF8NAIK	Airport officials say that Israel's ambassador to Egypt has returned to Cairo after he and other embassy staffers fled on military planes when thousands of angry Egyptians attacked the embassy in September.	97	113	embassy staffers	3	2	5
3BO3NEOQM0I91MV6VAZ84CRBF8NAIK	Airport officials say that Israel's ambassador to Egypt has returned to Cairo after he and other embassy staffers fled on military planes when thousands of angry Egyptians attacked the embassy in September.	105	113	staffers	4	8	12
3BO3NEOQM0I91MV6VAZ84CRBF8NAIK	Airport officials say that Israel's ambassador to Egypt has returned to Cairo after he and other embassy staffers fled on military planes when thousands of angry Egyptians attacked the embassy in September.	105	118	staffers fled	0	1	1
3BO3NEOQM0I91MV6VAZ84CRBF8NAIK	Airport officials say that Israel's ambassador to Egypt has returned to Cairo after he and other embassy staffers fled on military planes when thousands of angry Egyptians attacked the embassy in September.	114	118	fled	1	1	2
3BO3NEOQM0I91MV6VAZ84CRBF8NAIK	Airport officials say that Israel's ambassador to Egypt has returned to Cairo after he and other embassy staffers fled on military planes when thousands of angry Egyptians attacked the embassy in September.	143	152	thousands	1	0	1
3BO3NEOQM0I91MV6VAZ84CRBF8NAIK	Airport officials say that Israel's ambassador to Egypt has returned to Cairo after he and other embassy staffers fled on military planes when thousands of angry Egyptians attacked the embassy in September.	162	171	Egyptians	1	0	1
3BO3NEOQM0I91MV6VAZ84CRBF8NAIK	Airport officials say that Israel's ambassador to Egypt has returned to Cairo after he and other embassy staffers fled on military planes when thousands of angry Egyptians attacked the embassy in September.	172	180	attacked	0	1	1
3BO3NEOQM0I91MV6VAZ84CRBF8NAIK	Airport officials say that Israel's ambassador to Egypt has returned to Cairo after he and other embassy staffers fled on military planes when thousands of angry Egyptians attacked the embassy in September.	185	192	embassy	2	3	5
3BO3NEOQM0I91MV6VAZ84CRBF8NAIK	An official who spoke on condition of anonymity because he was not authorized to speak to the press said Yitzhak Levanon returned to Cairo Sunday through Istanbul.	22	47	on condition of anonymity	1	0	1
3BO3NEOQM0I91MV6VAZ84CRBF8NAIK	An official who spoke on condition of anonymity because he was not authorized to speak to the press said Yitzhak Levanon returned to Cairo Sunday through Istanbul.	25	34	condition	0	1	1
3BO3NEOQM0I91MV6VAZ84CRBF8NAIK	An official who spoke on condition of anonymity because he was not authorized to speak to the press said Yitzhak Levanon returned to Cairo Sunday through Istanbul.	25	47	condition of anonymity	4	0	4
3BO3NEOQM0I91MV6VAZ84CRBF8NAIK	An official who spoke on condition of anonymity because he was not authorized to speak to the press said Yitzhak Levanon returned to Cairo Sunday through Istanbul.	38	47	anonymity	8	9	17
3BO3NEOQM0I91MV6VAZ84CRBF8NAIK	An official who spoke on condition of anonymity because he was not authorized to speak to the press said Yitzhak Levanon returned to Cairo Sunday through Istanbul.	63	77	not authorized	1	0	1
3BO3NEOQM0I91MV6VAZ84CRBF8NAIK	An official who spoke on condition of anonymity because he was not authorized to speak to the press said Yitzhak Levanon returned to Cairo Sunday through Istanbul.	67	77	authorized	4	5	9
3BO3NEOQM0I91MV6VAZ84CRBF8NAIK	An official who spoke on condition of anonymity because he was not authorized to speak to the press said Yitzhak Levanon returned to Cairo Sunday through Istanbul.	94	99	press	1	0	1
3BO3NEOQM0I91MV6VAZ84CRBF8NAIK	An official who spoke on condition of anonymity because he was not authorized to speak to the press said Yitzhak Levanon returned to Cairo Sunday through Istanbul.	105	120	Yitzhak Levanon	1	0	1
3G57RS03HH68KV5NBBNZ9L48XX1527	Witnesses said the insurgents were dressed completely in Islamic veils to conceal their weapons, the Journal said.	0	9	Witnesses	2	1	3
3G57RS03HH68KV5NBBNZ9L48XX1527	Witnesses said the insurgents were dressed completely in Islamic veils to conceal their weapons, the Journal said.	19	29	insurgents	10	8	18
3G57RS03HH68KV5NBBNZ9L48XX1527	Witnesses said the insurgents were dressed completely in Islamic veils to conceal their weapons, the Journal said.	57	70	Islamic veils	1	2	3
3G57RS03HH68KV5NBBNZ9L48XX1527	Witnesses said the insurgents were dressed completely in Islamic veils to conceal their weapons, the Journal said.	65	70	veils	6	3	9
3G57RS03HH68KV5NBBNZ9L48XX1527	Witnesses said the insurgents were dressed completely in Islamic veils to conceal their weapons, the Journal said.	71	81	to conceal	0	1	1
3G57RS03HH68KV5NBBNZ9L48XX1527	Witnesses said the insurgents were dressed completely in Islamic veils to conceal their weapons, the Journal said.	74	81	conceal	9	7	16
3G57RS03HH68KV5NBBNZ9L48XX1527	Witnesses said the insurgents were dressed completely in Islamic veils to conceal their weapons, the Journal said.	88	95	weapons	1	0	1
3G57RS03HH68KV5NBBNZ9L48XX1527	Witnesses said the insurgents were dressed completely in Islamic veils to conceal their weapons, the Journal said.	101	108	Journal	0	2	2
3G57RS03HH68KV5NBBNZ9L48XX1527	One insurgent detonated a car bomb that destroyed the main gate and at least two insurgents entered the compound and took over a laundry and maintenance building.	4	13	insurgent	3	0	3
3G57RS03HH68KV5NBBNZ9L48XX1527	One insurgent detonated a car bomb that destroyed the main gate and at least two insurgents entered the compound and took over a laundry and maintenance building.	14	23	detonated	7	8	15
3G57RS03HH68KV5NBBNZ9L48XX1527	One insurgent detonated a car bomb that destroyed the main gate and at least two insurgents entered the compound and took over a laundry and maintenance building.	81	91	insurgents	5	1	6
3G57RS03HH68KV5NBBNZ9L48XX1527	One insurgent detonated a car bomb that destroyed the main gate and at least two insurgents entered the compound and took over a laundry and maintenance building.	104	112	compound	4	3	7
3G57RS03HH68KV5NBBNZ9L48XX1527	One insurgent detonated a car bomb that destroyed the main gate and at least two insurgents entered the compound and took over a laundry and maintenance building.	117	136	took over a laundry	0	1	1
3G57RS03HH68KV5NBBNZ9L48XX1527	One insurgent detonated a car bomb that destroyed the main gate and at least two insurgents entered the compound and took over a laundry and maintenance building.	129	136	laundry	0	2	2
3G57RS03HH68KV5NBBNZ9L48XX1527	One insurgent detonated a car bomb that destroyed the main gate and at least two insurgents entered the compound and took over a laundry and maintenance building.	141	152	maintenance	1	0	1
3G57RS03HH68KV5NBBNZ9L48XX1527	One insurgent detonated a car bomb that destroyed the main gate and at least two insurgents entered the compound and took over a laundry and maintenance building.	141	161	maintenance building	2	0	2
3G57RS03HH68KV5NBBNZ9L48XX1527	Suicide bombers attacked a compound housing Westerners in Kabul on Wednesday hours after U.S. President Barack Obama signed a security pact during a short visit to a city that remains vulnerable to a resilient insurgency.	0	15	Suicide bombers	1	1	2
3G57RS03HH68KV5NBBNZ9L48XX1527	Suicide bombers attacked a compound housing Westerners in Kabul on Wednesday hours after U.S. President Barack Obama signed a security pact during a short visit to a city that remains vulnerable to a resilient insurgency.	27	43	compound housing	0	1	1
3G57RS03HH68KV5NBBNZ9L48XX1527	Suicide bombers attacked a compound housing Westerners in Kabul on Wednesday hours after U.S. President Barack Obama signed a security pact during a short visit to a city that remains vulnerable to a resilient insurgency.	126	139	security pact	3	6	9
3G57RS03HH68KV5NBBNZ9L48XX1527	Suicide bombers attacked a compound housing Westerners in Kabul on Wednesday hours after U.S. President Barack Obama signed a security pact during a short visit to a city that remains vulnerable to a resilient insurgency.	135	139	pact	3	1	4
3G57RS03HH68KV5NBBNZ9L48XX1527	Suicide bombers attacked a compound housing Westerners in Kabul on Wednesday hours after U.S. President Barack Obama signed a security pact during a short visit to a city that remains vulnerable to a resilient insurgency.	184	194	vulnerable	7	7	14
3G57RS03HH68KV5NBBNZ9L48XX1527	Suicide bombers attacked a compound housing Westerners in Kabul on Wednesday hours after U.S. President Barack Obama signed a security pact during a short visit to a city that remains vulnerable to a resilient insurgency.	184	220	vulnerable to a resilient insurgency	1	0	1
3G57RS03HH68KV5NBBNZ9L48XX1527	Suicide bombers attacked a compound housing Westerners in Kabul on Wednesday hours after U.S. President Barack Obama signed a security pact during a short visit to a city that remains vulnerable to a resilient insurgency.	200	209	resilient	6	6	12
3G57RS03HH68KV5NBBNZ9L48XX1527	Suicide bombers attacked a compound housing Westerners in Kabul on Wednesday hours after U.S. President Barack Obama signed a security pact during a short visit to a city that remains vulnerable to a resilient insurgency.	200	220	resilient insurgency	4	5	9
3G57RS03HH68KV5NBBNZ9L48XX1527	Suicide bombers attacked a compound housing Westerners in Kabul on Wednesday hours after U.S. President Barack Obama signed a security pact during a short visit to a city that remains vulnerable to a resilient insurgency.	210	220	insurgency	2	3	5
3G57RS03HH68KV5NBBNZ9L48XX1527	The Taliban claimed responsibility for the attack which involved a car bomb and insurgents disguised as women on the eastern outskirts of the capital, killing seven people, a Gurkha guard and six passers-by, and wounding 17.	20	34	responsibility	0	1	1
3G57RS03HH68KV5NBBNZ9L48XX1527	The Taliban claimed responsibility for the attack which involved a car bomb and insurgents disguised as women on the eastern outskirts of the capital, killing seven people, a Gurkha guard and six passers-by, and wounding 17.	80	90	insurgents	3	1	4
3G57RS03HH68KV5NBBNZ9L48XX1527	The Taliban claimed responsibility for the attack which involved a car bomb and insurgents disguised as women on the eastern outskirts of the capital, killing seven people, a Gurkha guard and six passers-by, and wounding 17.	80	100	insurgents disguised	1	0	1
3G57RS03HH68KV5NBBNZ9L48XX1527	The Taliban claimed responsibility for the attack which involved a car bomb and insurgents disguised as women on the eastern outskirts of the capital, killing seven people, a Gurkha guard and six passers-by, and wounding 17.	91	100	disguised	3	8	11
3G57RS03HH68KV5NBBNZ9L48XX1527	The Taliban claimed responsibility for the attack which involved a car bomb and insurgents disguised as women on the eastern outskirts of the capital, killing seven people, a Gurkha guard and six passers-by, and wounding 17.	117	134	eastern outskirts	0	1	1
3G57RS03HH68KV5NBBNZ9L48XX1527	The Taliban claimed responsibility for the attack which involved a car bomb and insurgents disguised as women on the eastern outskirts of the capital, killing seven people, a Gurkha guard and six passers-by, and wounding 17.	125	134	outskirts	7	8	15
3G57RS03HH68KV5NBBNZ9L48XX1527	The Taliban claimed responsibility for the attack which involved a car bomb and insurgents disguised as women on the eastern outskirts of the capital, killing seven people, a Gurkha guard and six passers-by, and wounding 17.	175	181	Gurkha	1	0	1
3G57RS03HH68KV5NBBNZ9L48XX1527	The Taliban claimed responsibility for the attack which involved a car bomb and insurgents disguised as women on the eastern outskirts of the capital, killing seven people, a Gurkha guard and six passers-by, and wounding 17.	196	206	passers-by	0	2	2
3G57RS03HH68KV5NBBNZ9L48XX1527	The Taliban said it was in response to Obama's visit and to the strategic partnership deal he signed with Afghan President Hamid Karzai, a pact that sets out a long-term U.S. role after most foreign combat troops leave by the end of 2014.	64	73	strategic	5	4	9
3G57RS03HH68KV5NBBNZ9L48XX1527	The Taliban said it was in response to Obama's visit and to the strategic partnership deal he signed with Afghan President Hamid Karzai, a pact that sets out a long-term U.S. role after most foreign combat troops leave by the end of 2014.	64	85	strategic partnership	3	2	5
3G57RS03HH68KV5NBBNZ9L48XX1527	The Taliban said it was in response to Obama's visit and to the strategic partnership deal he signed with Afghan President Hamid Karzai, a pact that sets out a long-term U.S. role after most foreign combat troops leave by the end of 2014.	64	90	strategic partnership deal	2	0	2
3G57RS03HH68KV5NBBNZ9L48XX1527	The Taliban said it was in response to Obama's visit and to the strategic partnership deal he signed with Afghan President Hamid Karzai, a pact that sets out a long-term U.S. role after most foreign combat troops leave by the end of 2014.	139	143	pact	1	0	1
3G57RS03HH68KV5NBBNZ9L48XX1527	The Taliban said it was in response to Obama's visit and to the strategic partnership deal he signed with Afghan President Hamid Karzai, a pact that sets out a long-term U.S. role after most foreign combat troops leave by the end of 2014.	149	157	sets out	0	1	1
3G57RS03HH68KV5NBBNZ9L48XX1527	The Taliban said it was in response to Obama's visit and to the strategic partnership deal he signed with Afghan President Hamid Karzai, a pact that sets out a long-term U.S. role after most foreign combat troops leave by the end of 2014.	199	205	combat	2	1	3
3G57RS03HH68KV5NBBNZ9L48XX1527	The Taliban said it was in response to Obama's visit and to the strategic partnership deal he signed with Afghan President Hamid Karzai, a pact that sets out a long-term U.S. role after most foreign combat troops leave by the end of 2014.	199	212	combat troops	0	3	3
3G57RS03HH68KV5NBBNZ9L48XX1527	The Taliban said it was in response to Obama's visit and to the strategic partnership deal he signed with Afghan President Hamid Karzai, a pact that sets out a long-term U.S. role after most foreign combat troops leave by the end of 2014.	206	212	troops	0	1	1
3L4YG5VW9NTQRIIWN6PZ3GJ486CDDN	Shortly afterward, three children knocked on the neighbour's door and said they had been shot, Lt Goodyear said.	8	17	afterward	4	3	7
3L4YG5VW9NTQRIIWN6PZ3GJ486CDDN	Shortly afterward, three children knocked on the neighbour's door and said they had been shot, Lt Goodyear said.	34	41	knocked	1	4	5
3L4YG5VW9NTQRIIWN6PZ3GJ486CDDN	Shortly afterward, three children knocked on the neighbour's door and said they had been shot, Lt Goodyear said.	49	59	neighbours	2	3	5
3L4YG5VW9NTQRIIWN6PZ3GJ486CDDN	Shortly afterward, three children knocked on the neighbour's door and said they had been shot, Lt Goodyear said.	49	64	neighbours door	1	0	1
3L4YG5VW9NTQRIIWN6PZ3GJ486CDDN	They obeyed and went home, according to Lt Goodyear.	5	11	obeyed	8	6	14
3L4YG5VW9NTQRIIWN6PZ3GJ486CDDN	They obeyed and went home, according to Lt Goodyear.	27	36	according	2	1	3
3L4YG5VW9NTQRIIWN6PZ3GJ486CDDN	The neighbour then heard more gunshots and called 911 again.	4	13	neighbour	0	1	1
3L4YG5VW9NTQRIIWN6PZ3GJ486CDDN	The neighbour then heard more gunshots and called 911 again.	19	24	heard	1	1	2
3L4YG5VW9NTQRIIWN6PZ3GJ486CDDN	The neighbour then heard more gunshots and called 911 again.	30	38	gunshots	0	3	3
3L4YG5VW9NTQRIIWN6PZ3GJ486CDDN	When police arrived on the scene at 4.54am, they found 17-year-old Pebbles Johnson suffering from gunshot wounds outside and heard four shots from inside the house.	12	19	arrived	0	1	1
3L4YG5VW9NTQRIIWN6PZ3GJ486CDDN	When police arrived on the scene at 4.54am, they found 17-year-old Pebbles Johnson suffering from gunshot wounds outside and heard four shots from inside the house.	20	32	on the scene	1	0	1
3L4YG5VW9NTQRIIWN6PZ3GJ486CDDN	When police arrived on the scene at 4.54am, they found 17-year-old Pebbles Johnson suffering from gunshot wounds outside and heard four shots from inside the house.	67	74	Pebbles	0	1	1
3L4YG5VW9NTQRIIWN6PZ3GJ486CDDN	When police arrived on the scene at 4.54am, they found 17-year-old Pebbles Johnson suffering from gunshot wounds outside and heard four shots from inside the house.	83	92	suffering	5	3	8
3L4YG5VW9NTQRIIWN6PZ3GJ486CDDN	When police arrived on the scene at 4.54am, they found 17-year-old Pebbles Johnson suffering from gunshot wounds outside and heard four shots from inside the house.	98	105	gunshot	1	0	1
3L4YG5VW9NTQRIIWN6PZ3GJ486CDDN	When police arrived on the scene at 4.54am, they found 17-year-old Pebbles Johnson suffering from gunshot wounds outside and heard four shots from inside the house.	98	112	gunshot wounds	0	1	1
3L4YG5VW9NTQRIIWN6PZ3GJ486CDDN	When police arrived on the scene at 4.54am, they found 17-year-old Pebbles Johnson suffering from gunshot wounds outside and heard four shots from inside the house.	106	112	wounds	0	2	2
3L4YG5VW9NTQRIIWN6PZ3GJ486CDDN	When police arrived on the scene at 4.54am, they found 17-year-old Pebbles Johnson suffering from gunshot wounds outside and heard four shots from inside the house.	125	130	heard	0	1	1
3L4YG5VW9NTQRIIWN6PZ3GJ486CDDN	The teen was taken to an ambulance in a police car, but she died before the ambulance reached the hospital.	4	8	teen	0	1	1
3L4YG5VW9NTQRIIWN6PZ3GJ486CDDN	The teen was taken to an ambulance in a police car, but she died before the ambulance reached the hospital.	25	34	ambulance	7	1	8
3L4YG5VW9NTQRIIWN6PZ3GJ486CDDN	The teen was taken to an ambulance in a police car, but she died before the ambulance reached the hospital.	25	50	ambulance in a police car	1	0	1
3L4YG5VW9NTQRIIWN6PZ3GJ486CDDN	The teen was taken to an ambulance in a police car, but she died before the ambulance reached the hospital.	76	85	ambulance	1	1	2
3L4YG5VW9NTQRIIWN6PZ3GJ486CDDN	Thomas then emerged with a gun, saw more police approaching her home and went back inside.	12	19	emerged	10	6	16
3L4YG5VW9NTQRIIWN6PZ3GJ486CDDN	Thomas then emerged with a gun, saw more police approaching her home and went back inside.	36	59	more police approaching	1	0	1
3L4YG5VW9NTQRIIWN6PZ3GJ486CDDN	Thomas then emerged with a gun, saw more police approaching her home and went back inside.	48	59	approaching	6	5	11
3L4YG5VW9NTQRIIWN6PZ3GJ486CDDN	At 5.26am, one final gunshot was heard, Lt Goodyear said.	21	28	gunshot	1	0	1
3NCN4N1H1GI6YXBPY4CW4V7YICZNBE	Fighting flared in Tripoli again on Monday leaving one person dead and nine wounded, a security official told AFP.	0	15	Fighting flared	1	2	3
3NCN4N1H1GI6YXBPY4CW4V7YICZNBE	Fighting flared in Tripoli again on Monday leaving one person dead and nine wounded, a security official told AFP.	9	15	flared	10	10	20
3NCN4N1H1GI6YXBPY4CW4V7YICZNBE	Fighting flared in Tripoli again on Monday leaving one person dead and nine wounded, a security official told AFP.	19	26	Tripoli	1	0	1
3NCN4N1H1GI6YXBPY4CW4V7YICZNBE	Fighting flared in Tripoli again on Monday leaving one person dead and nine wounded, a security official told AFP.	76	83	wounded	0	3	3
3NCN4N1H1GI6YXBPY4CW4V7YICZNBE	He said the victim died in the neighbourhood of Jabal Mohsen, populated mainly by members of Assad's Alawite sect, an offshoot of Shiite Islam.	12	18	victim	1	2	3
3NCN4N1H1GI6YXBPY4CW4V7YICZNBE	He said the victim died in the neighbourhood of Jabal Mohsen, populated mainly by members of Assad's Alawite sect, an offshoot of Shiite Islam.	31	44	neighbourhood	1	1	2
3NCN4N1H1GI6YXBPY4CW4V7YICZNBE	He said the victim died in the neighbourhood of Jabal Mohsen, populated mainly by members of Assad's Alawite sect, an offshoot of Shiite Islam.	48	60	Jabal Mohsen	1	0	1
3NCN4N1H1GI6YXBPY4CW4V7YICZNBE	He said the victim died in the neighbourhood of Jabal Mohsen, populated mainly by members of Assad's Alawite sect, an offshoot of Shiite Islam.	62	71	populated	2	1	3
3NCN4N1H1GI6YXBPY4CW4V7YICZNBE	He said the victim died in the neighbourhood of Jabal Mohsen, populated mainly by members of Assad's Alawite sect, an offshoot of Shiite Islam.	93	112	Assads Alawite sect	1	0	1
3NCN4N1H1GI6YXBPY4CW4V7YICZNBE	He said the victim died in the neighbourhood of Jabal Mohsen, populated mainly by members of Assad's Alawite sect, an offshoot of Shiite Islam.	101	113	Alawite sect	0	1	1
3NCN4N1H1GI6YXBPY4CW4V7YICZNBE	He said the victim died in the neighbourhood of Jabal Mohsen, populated mainly by members of Assad's Alawite sect, an offshoot of Shiite Islam.	109	113	sect	4	1	5
3NCN4N1H1GI6YXBPY4CW4V7YICZNBE	He said the victim died in the neighbourhood of Jabal Mohsen, populated mainly by members of Assad's Alawite sect, an offshoot of Shiite Islam.	118	126	offshoot	10	8	18
3NCN4N1H1GI6YXBPY4CW4V7YICZNBE	He said the victim died in the neighbourhood of Jabal Mohsen, populated mainly by members of Assad's Alawite sect, an offshoot of Shiite Islam.	118	142	offshoot of Shiite Islam	1	0	1
3NCN4N1H1GI6YXBPY4CW4V7YICZNBE	Battles first erupted on Saturday between residents of Jabal Mohsen and the nearby neighbourhood of Bab al-Tebbaneh -- populated mainly by Sunni Muslims opposed to Assad's regime -- after security forces arrested a Sunni Islamist on suspicion he was linked to a terrorist organisation.	0	7	Battles	0	2	2
3NCN4N1H1GI6YXBPY4CW4V7YICZNBE	Battles first erupted on Saturday between residents of Jabal Mohsen and the nearby neighbourhood of Bab al-Tebbaneh -- populated mainly by Sunni Muslims opposed to Assad's regime -- after security forces arrested a Sunni Islamist on suspicion he was linked to a terrorist organisation.	14	21	erupted	5	9	14
3NCN4N1H1GI6YXBPY4CW4V7YICZNBE	Battles first erupted on Saturday between residents of Jabal Mohsen and the nearby neighbourhood of Bab al-Tebbaneh -- populated mainly by Sunni Muslims opposed to Assad's regime -- after security forces arrested a Sunni Islamist on suspicion he was linked to a terrorist organisation.	83	96	neighbourhood	0	1	1
3NCN4N1H1GI6YXBPY4CW4V7YICZNBE	Battles first erupted on Saturday between residents of Jabal Mohsen and the nearby neighbourhood of Bab al-Tebbaneh -- populated mainly by Sunni Muslims opposed to Assad's regime -- after security forces arrested a Sunni Islamist on suspicion he was linked to a terrorist organisation.	100	115	Bab al-Tebbaneh	2	0	2
3NCN4N1H1GI6YXBPY4CW4V7YICZNBE	Battles first erupted on Saturday between residents of Jabal Mohsen and the nearby neighbourhood of Bab al-Tebbaneh -- populated mainly by Sunni Muslims opposed to Assad's regime -- after security forces arrested a Sunni Islamist on suspicion he was linked to a terrorist organisation.	119	128	populated	3	1	4
3NCN4N1H1GI6YXBPY4CW4V7YICZNBE	Battles first erupted on Saturday between residents of Jabal Mohsen and the nearby neighbourhood of Bab al-Tebbaneh -- populated mainly by Sunni Muslims opposed to Assad's regime -- after security forces arrested a Sunni Islamist on suspicion he was linked to a terrorist organisation.	139	144	Sunni	0	1	1
3NCN4N1H1GI6YXBPY4CW4V7YICZNBE	Battles first erupted on Saturday between residents of Jabal Mohsen and the nearby neighbourhood of Bab al-Tebbaneh -- populated mainly by Sunni Muslims opposed to Assad's regime -- after security forces arrested a Sunni Islamist on suspicion he was linked to a terrorist organisation.	153	160	opposed	1	1	2
3NCN4N1H1GI6YXBPY4CW4V7YICZNBE	Battles first erupted on Saturday between residents of Jabal Mohsen and the nearby neighbourhood of Bab al-Tebbaneh -- populated mainly by Sunni Muslims opposed to Assad's regime -- after security forces arrested a Sunni Islamist on suspicion he was linked to a terrorist organisation.	164	177	Assads regime	1	0	1
3NCN4N1H1GI6YXBPY4CW4V7YICZNBE	Battles first erupted on Saturday between residents of Jabal Mohsen and the nearby neighbourhood of Bab al-Tebbaneh -- populated mainly by Sunni Muslims opposed to Assad's regime -- after security forces arrested a Sunni Islamist on suspicion he was linked to a terrorist organisation.	172	178	regime	5	3	8
3NCN4N1H1GI6YXBPY4CW4V7YICZNBE	Battles first erupted on Saturday between residents of Jabal Mohsen and the nearby neighbourhood of Bab al-Tebbaneh -- populated mainly by Sunni Muslims opposed to Assad's regime -- after security forces arrested a Sunni Islamist on suspicion he was linked to a terrorist organisation.	188	196	security	1	0	1
3NCN4N1H1GI6YXBPY4CW4V7YICZNBE	Battles first erupted on Saturday between residents of Jabal Mohsen and the nearby neighbourhood of Bab al-Tebbaneh -- populated mainly by Sunni Muslims opposed to Assad's regime -- after security forces arrested a Sunni Islamist on suspicion he was linked to a terrorist organisation.	215	220	Sunni	0	1	1
3NCN4N1H1GI6YXBPY4CW4V7YICZNBE	Battles first erupted on Saturday between residents of Jabal Mohsen and the nearby neighbourhood of Bab al-Tebbaneh -- populated mainly by Sunni Muslims opposed to Assad's regime -- after security forces arrested a Sunni Islamist on suspicion he was linked to a terrorist organisation.	221	229	Islamist	0	1	1
3NCN4N1H1GI6YXBPY4CW4V7YICZNBE	Battles first erupted on Saturday between residents of Jabal Mohsen and the nearby neighbourhood of Bab al-Tebbaneh -- populated mainly by Sunni Muslims opposed to Assad's regime -- after security forces arrested a Sunni Islamist on suspicion he was linked to a terrorist organisation.	233	242	suspicion	8	10	18
3NCN4N1H1GI6YXBPY4CW4V7YICZNBE	Battles first erupted on Saturday between residents of Jabal Mohsen and the nearby neighbourhood of Bab al-Tebbaneh -- populated mainly by Sunni Muslims opposed to Assad's regime -- after security forces arrested a Sunni Islamist on suspicion he was linked to a terrorist organisation.	250	256	linked	0	2	2
3NCN4N1H1GI6YXBPY4CW4V7YICZNBE	Battles first erupted on Saturday between residents of Jabal Mohsen and the nearby neighbourhood of Bab al-Tebbaneh -- populated mainly by Sunni Muslims opposed to Assad's regime -- after security forces arrested a Sunni Islamist on suspicion he was linked to a terrorist organisation.	262	271	terrorist	0	1	1
3NCN4N1H1GI6YXBPY4CW4V7YICZNBE	Battles first erupted on Saturday between residents of Jabal Mohsen and the nearby neighbourhood of Bab al-Tebbaneh -- populated mainly by Sunni Muslims opposed to Assad's regime -- after security forces arrested a Sunni Islamist on suspicion he was linked to a terrorist organisation.	262	284	terrorist organisation	0	1	1
3NCN4N1H1GI6YXBPY4CW4V7YICZNBE	On the diplomatic front, European Union foreign ministers meeting in Brussels on Monday  agreed fresh sanctions against Syria, the 15th round so far to protest the relentless repression of dissidents by Assad's regime.	7	17	diplomatic	4	3	7
3NCN4N1H1GI6YXBPY4CW4V7YICZNBE	On the diplomatic front, European Union foreign ministers meeting in Brussels on Monday  agreed fresh sanctions against Syria, the 15th round so far to protest the relentless repression of dissidents by Assad's regime.	7	23	diplomatic front	4	2	6
3NCN4N1H1GI6YXBPY4CW4V7YICZNBE	On the diplomatic front, European Union foreign ministers meeting in Brussels on Monday  agreed fresh sanctions against Syria, the 15th round so far to protest the relentless repression of dissidents by Assad's regime.	48	57	ministers	1	0	1
3NCN4N1H1GI6YXBPY4CW4V7YICZNBE	On the diplomatic front, European Union foreign ministers meeting in Brussels on Monday  agreed fresh sanctions against Syria, the 15th round so far to protest the relentless repression of dissidents by Assad's regime.	96	101	fresh	0	2	2
3NCN4N1H1GI6YXBPY4CW4V7YICZNBE	On the diplomatic front, European Union foreign ministers meeting in Brussels on Monday  agreed fresh sanctions against Syria, the 15th round so far to protest the relentless repression of dissidents by Assad's regime.	96	111	fresh sanctions	3	0	3
3NCN4N1H1GI6YXBPY4CW4V7YICZNBE	On the diplomatic front, European Union foreign ministers meeting in Brussels on Monday  agreed fresh sanctions against Syria, the 15th round so far to protest the relentless repression of dissidents by Assad's regime.	102	111	sanctions	8	4	12
3NCN4N1H1GI6YXBPY4CW4V7YICZNBE	On the diplomatic front, European Union foreign ministers meeting in Brussels on Monday  agreed fresh sanctions against Syria, the 15th round so far to protest the relentless repression of dissidents by Assad's regime.	164	174	relentless	4	7	11
3NCN4N1H1GI6YXBPY4CW4V7YICZNBE	On the diplomatic front, European Union foreign ministers meeting in Brussels on Monday  agreed fresh sanctions against Syria, the 15th round so far to protest the relentless repression of dissidents by Assad's regime.	164	185	relentless repression	2	6	8
3NCN4N1H1GI6YXBPY4CW4V7YICZNBE	On the diplomatic front, European Union foreign ministers meeting in Brussels on Monday  agreed fresh sanctions against Syria, the 15th round so far to protest the relentless repression of dissidents by Assad's regime.	164	199	relentless repression of dissidents	2	1	3
3NCN4N1H1GI6YXBPY4CW4V7YICZNBE	On the diplomatic front, European Union foreign ministers meeting in Brussels on Monday  agreed fresh sanctions against Syria, the 15th round so far to protest the relentless repression of dissidents by Assad's regime.	175	185	repression	7	5	12
3NCN4N1H1GI6YXBPY4CW4V7YICZNBE	On the diplomatic front, European Union foreign ministers meeting in Brussels on Monday  agreed fresh sanctions against Syria, the 15th round so far to protest the relentless repression of dissidents by Assad's regime.	189	199	dissidents	10	10	20
3NCN4N1H1GI6YXBPY4CW4V7YICZNBE	On the diplomatic front, European Union foreign ministers meeting in Brussels on Monday  agreed fresh sanctions against Syria, the 15th round so far to protest the relentless repression of dissidents by Assad's regime.	211	217	regime	1	1	2
3FK4G712NX12VWKWHMFDTER49ZTSSW	Those forces are scheduled to end combat operations after 2014, about thirteen years after the war began.	6	26	forces are scheduled	1	0	1
3FK4G712NX12VWKWHMFDTER49ZTSSW	Those forces are scheduled to end combat operations after 2014, about thirteen years after the war began.	17	26	scheduled	3	5	8
3FK4G712NX12VWKWHMFDTER49ZTSSW	Those forces are scheduled to end combat operations after 2014, about thirteen years after the war began.	17	51	scheduled to end combat operations	1	0	1
3FK4G712NX12VWKWHMFDTER49ZTSSW	Those forces are scheduled to end combat operations after 2014, about thirteen years after the war began.	34	40	combat	1	4	5
3FK4G712NX12VWKWHMFDTER49ZTSSW	Those forces are scheduled to end combat operations after 2014, about thirteen years after the war began.	34	51	combat operations	6	4	10
3FK4G712NX12VWKWHMFDTER49ZTSSW	Those forces are scheduled to end combat operations after 2014, about thirteen years after the war began.	41	51	operations	1	0	1
3FK4G712NX12VWKWHMFDTER49ZTSSW	"I recognize that many Americans are tired of war.	3	12	recognize	2	6	8
3FK4G712NX12VWKWHMFDTER49ZTSSW	As president, nothing is more wrenching than signing a letter to a family of the fallen, or looking into the eyes of a child who will grow up without a mother or father," Mr Obama said.	30	39	wrenching	10	10	20
3FK4G712NX12VWKWHMFDTER49ZTSSW	As president, nothing is more wrenching than signing a letter to a family of the fallen, or looking into the eyes of a child who will grow up without a mother or father," Mr Obama said.	81	87	fallen	2	2	4
3FK4G712NX12VWKWHMFDTER49ZTSSW	Still, the president vowed not to compromise the earlier efforts as he sought to wind down the war.	21	26	vowed	2	10	12
3FK4G712NX12VWKWHMFDTER49ZTSSW	Still, the president vowed not to compromise the earlier efforts as he sought to wind down the war.	21	44	vowed not to compromise	1	0	1
3FK4G712NX12VWKWHMFDTER49ZTSSW	Still, the president vowed not to compromise the earlier efforts as he sought to wind down the war.	34	44	compromise	10	6	16
3FK4G712NX12VWKWHMFDTER49ZTSSW	Still, the president vowed not to compromise the earlier efforts as he sought to wind down the war.	71	77	sought	1	5	6
3FK4G712NX12VWKWHMFDTER49ZTSSW	Still, the president vowed not to compromise the earlier efforts as he sought to wind down the war.	71	80	sought to	1	0	1
3FK4G712NX12VWKWHMFDTER49ZTSSW	Still, the president vowed not to compromise the earlier efforts as he sought to wind down the war.	81	90	wind down	3	2	5
3FK4G712NX12VWKWHMFDTER49ZTSSW	"I will not keep Americans in harm's way a single day longer than is absolutely required for our national security.	17	26	Americans	1	0	1
3FK4G712NX12VWKWHMFDTER49ZTSSW	"I will not keep Americans in harm's way a single day longer than is absolutely required for our national security.	30	39	harms way	0	3	3
3FK4G712NX12VWKWHMFDTER49ZTSSW	"I will not keep Americans in harm's way a single day longer than is absolutely required for our national security.	69	79	absolutely	1	1	2
3FK4G712NX12VWKWHMFDTER49ZTSSW	"I will not keep Americans in harm's way a single day longer than is absolutely required for our national security.	97	105	national	1	0	1
3FK4G712NX12VWKWHMFDTER49ZTSSW	"I will not keep Americans in harm's way a single day longer than is absolutely required for our national security.	97	114	national security	4	2	6
3FK4G712NX12VWKWHMFDTER49ZTSSW	But we must finish the job we started in Afghanistan and end this war responsibly," he said.	41	52	Afghanistan	1	0	1
3FK4G712NX12VWKWHMFDTER49ZTSSW	But we must finish the job we started in Afghanistan and end this war responsibly," he said.	70	81	responsibly	2	3	5
3FK4G712NX12VWKWHMFDTER49ZTSSW	The visit is the third trip for Mr. Obama as president, with his most recent time there taking place in late 2010.	70	76	recent	0	1	1
3FI30CQHVKKYRC5XZNQF2KLCNMA6BN	Fierce clashes between regime forces and armed rebels in central Syria Monday killed 23 Syrian soldiers and wounded dozens, a watchdog said, as the EU slapped fresh sanctions on the Damascus regime.	0	6	Fierce	5	5	10
3FI30CQHVKKYRC5XZNQF2KLCNMA6BN	Fierce clashes between regime forces and armed rebels in central Syria Monday killed 23 Syrian soldiers and wounded dozens, a watchdog said, as the EU slapped fresh sanctions on the Damascus regime.	0	14	Fierce clashes	0	1	1
3FI30CQHVKKYRC5XZNQF2KLCNMA6BN	Fierce clashes between regime forces and armed rebels in central Syria Monday killed 23 Syrian soldiers and wounded dozens, a watchdog said, as the EU slapped fresh sanctions on the Damascus regime.	7	14	clashes	1	0	1
3FI30CQHVKKYRC5XZNQF2KLCNMA6BN	Fierce clashes between regime forces and armed rebels in central Syria Monday killed 23 Syrian soldiers and wounded dozens, a watchdog said, as the EU slapped fresh sanctions on the Damascus regime.	23	29	regime	6	3	9
3FI30CQHVKKYRC5XZNQF2KLCNMA6BN	Fierce clashes between regime forces and armed rebels in central Syria Monday killed 23 Syrian soldiers and wounded dozens, a watchdog said, as the EU slapped fresh sanctions on the Damascus regime.	23	36	regime forces	2	0	2
3FI30CQHVKKYRC5XZNQF2KLCNMA6BN	Fierce clashes between regime forces and armed rebels in central Syria Monday killed 23 Syrian soldiers and wounded dozens, a watchdog said, as the EU slapped fresh sanctions on the Damascus regime.	41	53	armed rebels	1	0	1
3FI30CQHVKKYRC5XZNQF2KLCNMA6BN	Fierce clashes between regime forces and armed rebels in central Syria Monday killed 23 Syrian soldiers and wounded dozens, a watchdog said, as the EU slapped fresh sanctions on the Damascus regime.	47	53	rebels	1	4	5
3FI30CQHVKKYRC5XZNQF2KLCNMA6BN	Fierce clashes between regime forces and armed rebels in central Syria Monday killed 23 Syrian soldiers and wounded dozens, a watchdog said, as the EU slapped fresh sanctions on the Damascus regime.	108	115	wounded	1	3	4
3FI30CQHVKKYRC5XZNQF2KLCNMA6BN	Fierce clashes between regime forces and armed rebels in central Syria Monday killed 23 Syrian soldiers and wounded dozens, a watchdog said, as the EU slapped fresh sanctions on the Damascus regime.	126	134	watchdog	8	6	14
3FI30CQHVKKYRC5XZNQF2KLCNMA6BN	Fierce clashes between regime forces and armed rebels in central Syria Monday killed 23 Syrian soldiers and wounded dozens, a watchdog said, as the EU slapped fresh sanctions on the Damascus regime.	151	158	slapped	2	3	5
3FI30CQHVKKYRC5XZNQF2KLCNMA6BN	Fierce clashes between regime forces and armed rebels in central Syria Monday killed 23 Syrian soldiers and wounded dozens, a watchdog said, as the EU slapped fresh sanctions on the Damascus regime.	151	174	slapped fresh sanctions	2	0	2
3FI30CQHVKKYRC5XZNQF2KLCNMA6BN	Fierce clashes between regime forces and armed rebels in central Syria Monday killed 23 Syrian soldiers and wounded dozens, a watchdog said, as the EU slapped fresh sanctions on the Damascus regime.	159	174	fresh sanctions	2	0	2
3FI30CQHVKKYRC5XZNQF2KLCNMA6BN	Fierce clashes between regime forces and armed rebels in central Syria Monday killed 23 Syrian soldiers and wounded dozens, a watchdog said, as the EU slapped fresh sanctions on the Damascus regime.	165	174	sanctions	6	2	8
3FI30CQHVKKYRC5XZNQF2KLCNMA6BN	Fierce clashes between regime forces and armed rebels in central Syria Monday killed 23 Syrian soldiers and wounded dozens, a watchdog said, as the EU slapped fresh sanctions on the Damascus regime.	182	197	Damascus regime	1	0	1
3FI30CQHVKKYRC5XZNQF2KLCNMA6BN	Fierce clashes between regime forces and armed rebels in central Syria Monday killed 23 Syrian soldiers and wounded dozens, a watchdog said, as the EU slapped fresh sanctions on the Damascus regime.	191	197	regime	2	0	2
3FI30CQHVKKYRC5XZNQF2KLCNMA6BN	The Syrian Observatory for Human Rights said three troop carriers were destroyed in the clashes that began at dawn on the outskirts of Rastan, a city located in restive Homs province.	0	39	The Syrian Observatory for Human Rights	1	0	1
3FI30CQHVKKYRC5XZNQF2KLCNMA6BN	The Syrian Observatory for Human Rights said three troop carriers were destroyed in the clashes that began at dawn on the outskirts of Rastan, a city located in restive Homs province.	11	22	Observatory	2	3	5
3FI30CQHVKKYRC5XZNQF2KLCNMA6BN	The Syrian Observatory for Human Rights said three troop carriers were destroyed in the clashes that began at dawn on the outskirts of Rastan, a city located in restive Homs province.	51	65	troop carriers	1	0	1
3FI30CQHVKKYRC5XZNQF2KLCNMA6BN	The Syrian Observatory for Human Rights said three troop carriers were destroyed in the clashes that began at dawn on the outskirts of Rastan, a city located in restive Homs province.	57	65	carriers	0	1	1
3FI30CQHVKKYRC5XZNQF2KLCNMA6BN	The Syrian Observatory for Human Rights said three troop carriers were destroyed in the clashes that began at dawn on the outskirts of Rastan, a city located in restive Homs province.	71	80	destroyed	0	1	1
3FI30CQHVKKYRC5XZNQF2KLCNMA6BN	The Syrian Observatory for Human Rights said three troop carriers were destroyed in the clashes that began at dawn on the outskirts of Rastan, a city located in restive Homs province.	88	95	clashes	1	0	1
3FI30CQHVKKYRC5XZNQF2KLCNMA6BN	The Syrian Observatory for Human Rights said three troop carriers were destroyed in the clashes that began at dawn on the outskirts of Rastan, a city located in restive Homs province.	122	131	outskirts	7	6	13
3FI30CQHVKKYRC5XZNQF2KLCNMA6BN	The Syrian Observatory for Human Rights said three troop carriers were destroyed in the clashes that began at dawn on the outskirts of Rastan, a city located in restive Homs province.	161	168	restive	5	5	10
3FI30CQHVKKYRC5XZNQF2KLCNMA6BN	The Syrian Observatory for Human Rights said three troop carriers were destroyed in the clashes that began at dawn on the outskirts of Rastan, a city located in restive Homs province.	161	182	restive Homs province	1	0	1
3FI30CQHVKKYRC5XZNQF2KLCNMA6BN	The Syrian Observatory for Human Rights said three troop carriers were destroyed in the clashes that began at dawn on the outskirts of Rastan, a city located in restive Homs province.	174	182	province	2	1	3
3FI30CQHVKKYRC5XZNQF2KLCNMA6BN	Regime forces launched an offensive on the city at the weekend but have met with sharp resistance from rebels seeking the ouster of the regime of President Bashar al-Assad.	0	13	Regime forces	1	1	2
3FI30CQHVKKYRC5XZNQF2KLCNMA6BN	Regime forces launched an offensive on the city at the weekend but have met with sharp resistance from rebels seeking the ouster of the regime of President Bashar al-Assad.	14	22	launched	1	0	1
3FI30CQHVKKYRC5XZNQF2KLCNMA6BN	Regime forces launched an offensive on the city at the weekend but have met with sharp resistance from rebels seeking the ouster of the regime of President Bashar al-Assad.	26	35	offensive	3	2	5
3FI30CQHVKKYRC5XZNQF2KLCNMA6BN	Regime forces launched an offensive on the city at the weekend but have met with sharp resistance from rebels seeking the ouster of the regime of President Bashar al-Assad.	81	97	sharp resistance	4	1	5
3FI30CQHVKKYRC5XZNQF2KLCNMA6BN	Regime forces launched an offensive on the city at the weekend but have met with sharp resistance from rebels seeking the ouster of the regime of President Bashar al-Assad.	81	102	sharp resistance from	1	0	1
3FI30CQHVKKYRC5XZNQF2KLCNMA6BN	Regime forces launched an offensive on the city at the weekend but have met with sharp resistance from rebels seeking the ouster of the regime of President Bashar al-Assad.	87	97	resistance	2	2	4
3FI30CQHVKKYRC5XZNQF2KLCNMA6BN	Regime forces launched an offensive on the city at the weekend but have met with sharp resistance from rebels seeking the ouster of the regime of President Bashar al-Assad.	103	109	rebels	2	0	2
3FI30CQHVKKYRC5XZNQF2KLCNMA6BN	Regime forces launched an offensive on the city at the weekend but have met with sharp resistance from rebels seeking the ouster of the regime of President Bashar al-Assad.	122	128	ouster	7	7	14
3FI30CQHVKKYRC5XZNQF2KLCNMA6BN	The Observatory said dozens had been wounded in shelling of the city by Syrian troops.	4	15	Observatory	1	1	2
3FI30CQHVKKYRC5XZNQF2KLCNMA6BN	The Observatory said dozens had been wounded in shelling of the city by Syrian troops.	37	44	wounded	1	0	1
3FI30CQHVKKYRC5XZNQF2KLCNMA6BN	The Observatory said dozens had been wounded in shelling of the city by Syrian troops.	48	56	shelling	7	3	10
3FI30CQHVKKYRC5XZNQF2KLCNMA6BN	The Observatory said dozens had been wounded in shelling of the city by Syrian troops.	48	68	shelling of the city	1	0	1
3FI30CQHVKKYRC5XZNQF2KLCNMA6BN	Monday's killings come despite a month-old ceasefire brokered by UN-Arab League envoy Kofi Annan as part of a six-point plan aimed at ending violence that has swept Syria since March last year when a popular revolt erupted against Assad's regime.	23	30	despite	0	3	3
3FI30CQHVKKYRC5XZNQF2KLCNMA6BN	Monday's killings come despite a month-old ceasefire brokered by UN-Arab League envoy Kofi Annan as part of a six-point plan aimed at ending violence that has swept Syria since March last year when a popular revolt erupted against Assad's regime.	33	42	month-old	0	1	1
3FI30CQHVKKYRC5XZNQF2KLCNMA6BN	Monday's killings come despite a month-old ceasefire brokered by UN-Arab League envoy Kofi Annan as part of a six-point plan aimed at ending violence that has swept Syria since March last year when a popular revolt erupted against Assad's regime.	43	52	ceasefire	6	8	14
3FI30CQHVKKYRC5XZNQF2KLCNMA6BN	Monday's killings come despite a month-old ceasefire brokered by UN-Arab League envoy Kofi Annan as part of a six-point plan aimed at ending violence that has swept Syria since March last year when a popular revolt erupted against Assad's regime.	43	61	ceasefire brokered	4	1	5
3FI30CQHVKKYRC5XZNQF2KLCNMA6BN	Monday's killings come despite a month-old ceasefire brokered by UN-Arab League envoy Kofi Annan as part of a six-point plan aimed at ending violence that has swept Syria since March last year when a popular revolt erupted against Assad's regime.	53	61	brokered	1	6	7
3FI30CQHVKKYRC5XZNQF2KLCNMA6BN	Monday's killings come despite a month-old ceasefire brokered by UN-Arab League envoy Kofi Annan as part of a six-point plan aimed at ending violence that has swept Syria since March last year when a popular revolt erupted against Assad's regime.	80	85	envoy	1	3	4
3FI30CQHVKKYRC5XZNQF2KLCNMA6BN	Monday's killings come despite a month-old ceasefire brokered by UN-Arab League envoy Kofi Annan as part of a six-point plan aimed at ending violence that has swept Syria since March last year when a popular revolt erupted against Assad's regime.	110	119	six-point	1	0	1
3FI30CQHVKKYRC5XZNQF2KLCNMA6BN	Monday's killings come despite a month-old ceasefire brokered by UN-Arab League envoy Kofi Annan as part of a six-point plan aimed at ending violence that has swept Syria since March last year when a popular revolt erupted against Assad's regime.	110	124	six-point plan	1	0	1
3FI30CQHVKKYRC5XZNQF2KLCNMA6BN	Monday's killings come despite a month-old ceasefire brokered by UN-Arab League envoy Kofi Annan as part of a six-point plan aimed at ending violence that has swept Syria since March last year when a popular revolt erupted against Assad's regime.	141	149	violence	1	0	1
3FI30CQHVKKYRC5XZNQF2KLCNMA6BN	Monday's killings come despite a month-old ceasefire brokered by UN-Arab League envoy Kofi Annan as part of a six-point plan aimed at ending violence that has swept Syria since March last year when a popular revolt erupted against Assad's regime.	159	164	swept	2	3	5
3FI30CQHVKKYRC5XZNQF2KLCNMA6BN	Monday's killings come despite a month-old ceasefire brokered by UN-Arab League envoy Kofi Annan as part of a six-point plan aimed at ending violence that has swept Syria since March last year when a popular revolt erupted against Assad's regime.	208	214	revolt	4	2	6
3FI30CQHVKKYRC5XZNQF2KLCNMA6BN	Monday's killings come despite a month-old ceasefire brokered by UN-Arab League envoy Kofi Annan as part of a six-point plan aimed at ending violence that has swept Syria since March last year when a popular revolt erupted against Assad's regime.	208	222	revolt erupted	2	1	3
3FI30CQHVKKYRC5XZNQF2KLCNMA6BN	Monday's killings come despite a month-old ceasefire brokered by UN-Arab League envoy Kofi Annan as part of a six-point plan aimed at ending violence that has swept Syria since March last year when a popular revolt erupted against Assad's regime.	215	222	erupted	4	7	11
3FI30CQHVKKYRC5XZNQF2KLCNMA6BN	Monday's killings come despite a month-old ceasefire brokered by UN-Arab League envoy Kofi Annan as part of a six-point plan aimed at ending violence that has swept Syria since March last year when a popular revolt erupted against Assad's regime.	239	245	regime	2	0	2
3P6ENY9P79XOB93K1G90LYEFS3DHI2	Israeli Foreign Ministry officials indicated that the visit was a symbolic gesture, meant to signal Jerusalem's desire to return ties with its neighbor to the south to normalcy.	0	24	Israeli Foreign Ministry	1	0	1
3P6ENY9P79XOB93K1G90LYEFS3DHI2	Israeli Foreign Ministry officials indicated that the visit was a symbolic gesture, meant to signal Jerusalem's desire to return ties with its neighbor to the south to normalcy.	8	15	Foreign	1	0	1
3P6ENY9P79XOB93K1G90LYEFS3DHI2	Israeli Foreign Ministry officials indicated that the visit was a symbolic gesture, meant to signal Jerusalem's desire to return ties with its neighbor to the south to normalcy.	16	24	Ministry	1	0	1
3P6ENY9P79XOB93K1G90LYEFS3DHI2	Israeli Foreign Ministry officials indicated that the visit was a symbolic gesture, meant to signal Jerusalem's desire to return ties with its neighbor to the south to normalcy.	25	34	officials	1	0	1
3P6ENY9P79XOB93K1G90LYEFS3DHI2	Israeli Foreign Ministry officials indicated that the visit was a symbolic gesture, meant to signal Jerusalem's desire to return ties with its neighbor to the south to normalcy.	35	44	indicated	6	3	9
3P6ENY9P79XOB93K1G90LYEFS3DHI2	Israeli Foreign Ministry officials indicated that the visit was a symbolic gesture, meant to signal Jerusalem's desire to return ties with its neighbor to the south to normalcy.	66	74	symbolic	4	0	4
3P6ENY9P79XOB93K1G90LYEFS3DHI2	Israeli Foreign Ministry officials indicated that the visit was a symbolic gesture, meant to signal Jerusalem's desire to return ties with its neighbor to the south to normalcy.	66	82	symbolic gesture	8	6	14
3P6ENY9P79XOB93K1G90LYEFS3DHI2	Israeli Foreign Ministry officials indicated that the visit was a symbolic gesture, meant to signal Jerusalem's desire to return ties with its neighbor to the south to normalcy.	75	82	gesture	2	4	6
3P6ENY9P79XOB93K1G90LYEFS3DHI2	Israeli Foreign Ministry officials indicated that the visit was a symbolic gesture, meant to signal Jerusalem's desire to return ties with its neighbor to the south to normalcy.	93	99	signal	1	1	2
3P6ENY9P79XOB93K1G90LYEFS3DHI2	Israeli Foreign Ministry officials indicated that the visit was a symbolic gesture, meant to signal Jerusalem's desire to return ties with its neighbor to the south to normalcy.	112	118	desire	0	2	2
3P6ENY9P79XOB93K1G90LYEFS3DHI2	Israeli Foreign Ministry officials indicated that the visit was a symbolic gesture, meant to signal Jerusalem's desire to return ties with its neighbor to the south to normalcy.	122	133	return ties	1	1	2
3P6ENY9P79XOB93K1G90LYEFS3DHI2	Israeli Foreign Ministry officials indicated that the visit was a symbolic gesture, meant to signal Jerusalem's desire to return ties with its neighbor to the south to normalcy.	143	151	neighbor	0	1	1
3P6ENY9P79XOB93K1G90LYEFS3DHI2	Israeli Foreign Ministry officials indicated that the visit was a symbolic gesture, meant to signal Jerusalem's desire to return ties with its neighbor to the south to normalcy.	168	176	normalcy	10	7	17
3P6ENY9P79XOB93K1G90LYEFS3DHI2	However, Shin Bet officials have yet to approve the permanent return of Israel's envoy to Egypt for security reasons.	52	61	permanent	3	1	4
3P6ENY9P79XOB93K1G90LYEFS3DHI2	However, Shin Bet officials have yet to approve the permanent return of Israel's envoy to Egypt for security reasons.	52	68	permanent return	2	0	2
3P6ENY9P79XOB93K1G90LYEFS3DHI2	However, Shin Bet officials have yet to approve the permanent return of Israel's envoy to Egypt for security reasons.	72	85	Israels envoy	0	1	1
3P6ENY9P79XOB93K1G90LYEFS3DHI2	However, Shin Bet officials have yet to approve the permanent return of Israel's envoy to Egypt for security reasons.	81	86	envoy	6	8	14
3P6ENY9P79XOB93K1G90LYEFS3DHI2	However, Shin Bet officials have yet to approve the permanent return of Israel's envoy to Egypt for security reasons.	100	116	security reasons	0	1	1
3P6ENY9P79XOB93K1G90LYEFS3DHI2	Sources within the Foreign Ministry claimed that Egypt has yet to respond to an Israeli request regarding security arrangements near the ambassador's residence as well regarding the embassy's planned new location.	0	7	Sources	0	1	1
3P6ENY9P79XOB93K1G90LYEFS3DHI2	Sources within the Foreign Ministry claimed that Egypt has yet to respond to an Israeli request regarding security arrangements near the ambassador's residence as well regarding the embassy's planned new location.	36	43	claimed	0	2	2
3P6ENY9P79XOB93K1G90LYEFS3DHI2	Sources within the Foreign Ministry claimed that Egypt has yet to respond to an Israeli request regarding security arrangements near the ambassador's residence as well regarding the embassy's planned new location.	66	73	respond	0	1	1
3P6ENY9P79XOB93K1G90LYEFS3DHI2	Sources within the Foreign Ministry claimed that Egypt has yet to respond to an Israeli request regarding security arrangements near the ambassador's residence as well regarding the embassy's planned new location.	88	95	request	0	1	1
3P6ENY9P79XOB93K1G90LYEFS3DHI2	Sources within the Foreign Ministry claimed that Egypt has yet to respond to an Israeli request regarding security arrangements near the ambassador's residence as well regarding the embassy's planned new location.	96	105	regarding	1	0	1
3P6ENY9P79XOB93K1G90LYEFS3DHI2	Sources within the Foreign Ministry claimed that Egypt has yet to respond to an Israeli request regarding security arrangements near the ambassador's residence as well regarding the embassy's planned new location.	106	127	security arrangements	3	1	4
3P6ENY9P79XOB93K1G90LYEFS3DHI2	Sources within the Foreign Ministry claimed that Egypt has yet to respond to an Israeli request regarding security arrangements near the ambassador's residence as well regarding the embassy's planned new location.	115	127	arrangements	3	3	6
3P6ENY9P79XOB93K1G90LYEFS3DHI2	Sources within the Foreign Ministry claimed that Egypt has yet to respond to an Israeli request regarding security arrangements near the ambassador's residence as well regarding the embassy's planned new location.	137	147	ambassador	1	0	1
3P6ENY9P79XOB93K1G90LYEFS3DHI2	Sources within the Foreign Ministry claimed that Egypt has yet to respond to an Israeli request regarding security arrangements near the ambassador's residence as well regarding the embassy's planned new location.	137	148	ambassadors	2	2	4
3P6ENY9P79XOB93K1G90LYEFS3DHI2	Sources within the Foreign Ministry claimed that Egypt has yet to respond to an Israeli request regarding security arrangements near the ambassador's residence as well regarding the embassy's planned new location.	137	158	ambassadors residence	2	0	2
3P6ENY9P79XOB93K1G90LYEFS3DHI2	Sources within the Foreign Ministry claimed that Egypt has yet to respond to an Israeli request regarding security arrangements near the ambassador's residence as well regarding the embassy's planned new location.	150	159	residence	2	0	2
3P6ENY9P79XOB93K1G90LYEFS3DHI2	Sources within the Foreign Ministry claimed that Egypt has yet to respond to an Israeli request regarding security arrangements near the ambassador's residence as well regarding the embassy's planned new location.	168	177	regarding	1	0	1
3P6ENY9P79XOB93K1G90LYEFS3DHI2	Sources within the Foreign Ministry claimed that Egypt has yet to respond to an Israeli request regarding security arrangements near the ambassador's residence as well regarding the embassy's planned new location.	182	189	embassy	1	0	1
3P6ENY9P79XOB93K1G90LYEFS3DHI2	Sources within the Foreign Ministry claimed that Egypt has yet to respond to an Israeli request regarding security arrangements near the ambassador's residence as well regarding the embassy's planned new location.	182	190	embassys	3	2	5
3P6ENY9P79XOB93K1G90LYEFS3DHI2	Sources within the Foreign Ministry claimed that Egypt has yet to respond to an Israeli request regarding security arrangements near the ambassador's residence as well regarding the embassy's planned new location.	192	199	planned	0	1	1
3P6ENY9P79XOB93K1G90LYEFS3DHI2	Sources within the Foreign Ministry claimed that Egypt has yet to respond to an Israeli request regarding security arrangements near the ambassador's residence as well regarding the embassy's planned new location.	192	212	planned new location	0	1	1
3P6ENY9P79XOB93K1G90LYEFS3DHI2	Ya'akov Amitai has been named to replace Levanon as Israel's ambassador, and is expected to enter office in early December.	33	40	replace	1	1	2
3P6ENY9P79XOB93K1G90LYEFS3DHI2	Ya'akov Amitai has been named to replace Levanon as Israel's ambassador, and is expected to enter office in early December.	41	48	Levanon	0	1	1
3P6ENY9P79XOB93K1G90LYEFS3DHI2	Ya'akov Amitai has been named to replace Levanon as Israel's ambassador, and is expected to enter office in early December.	61	71	ambassador	2	1	3
3P6ENY9P79XOB93K1G90LYEFS3DHI2	Ya'akov Amitai has been named to replace Levanon as Israel's ambassador, and is expected to enter office in early December.	80	88	expected	1	2	3
3P6ENY9P79XOB93K1G90LYEFS3DHI2	It has not yet been made clear, however, whether the requested security arrangements will be in place at that time.	63	84	security arrangements	4	1	5
3P6ENY9P79XOB93K1G90LYEFS3DHI2	It has not yet been made clear, however, whether the requested security arrangements will be in place at that time.	72	84	arrangements	2	1	3
3P6ENY9P79XOB93K1G90LYEFS3DHI2	If security will not setup according to Israel's requests at that time, Amitai will arrive to submit his letter of credence, stay in Cairo for a few days, and return to Israel.	21	26	setup	0	1	1
3P6ENY9P79XOB93K1G90LYEFS3DHI2	If security will not setup according to Israel's requests at that time, Amitai will arrive to submit his letter of credence, stay in Cairo for a few days, and return to Israel.	49	57	requests	0	1	1
3P6ENY9P79XOB93K1G90LYEFS3DHI2	If security will not setup according to Israel's requests at that time, Amitai will arrive to submit his letter of credence, stay in Cairo for a few days, and return to Israel.	105	123	letter of credence	7	3	10
3P6ENY9P79XOB93K1G90LYEFS3DHI2	If security will not setup according to Israel's requests at that time, Amitai will arrive to submit his letter of credence, stay in Cairo for a few days, and return to Israel.	115	123	credence	3	10	13
3K1H3NEY7L0T32SNPWQ791M1KLPGD6	The government blames the bloodshed on armed gangs and extremists acting out a foreign plot to destabilize Syria.	15	21	blames	0	4	4
3K1H3NEY7L0T32SNPWQ791M1KLPGD6	The government blames the bloodshed on armed gangs and extremists acting out a foreign plot to destabilize Syria.	26	35	bloodshed	8	5	13
3K1H3NEY7L0T32SNPWQ791M1KLPGD6	The government blames the bloodshed on armed gangs and extremists acting out a foreign plot to destabilize Syria.	39	65	armed gangs and extremists	0	1	1
3K1H3NEY7L0T32SNPWQ791M1KLPGD6	The government blames the bloodshed on armed gangs and extremists acting out a foreign plot to destabilize Syria.	55	65	extremists	7	5	12
3K1H3NEY7L0T32SNPWQ791M1KLPGD6	The government blames the bloodshed on armed gangs and extremists acting out a foreign plot to destabilize Syria.	79	86	foreign	1	0	1
3K1H3NEY7L0T32SNPWQ791M1KLPGD6	The government blames the bloodshed on armed gangs and extremists acting out a foreign plot to destabilize Syria.	79	91	foreign plot	1	0	1
3K1H3NEY7L0T32SNPWQ791M1KLPGD6	The government blames the bloodshed on armed gangs and extremists acting out a foreign plot to destabilize Syria.	87	91	plot	0	1	1
3K1H3NEY7L0T32SNPWQ791M1KLPGD6	The government blames the bloodshed on armed gangs and extremists acting out a foreign plot to destabilize Syria.	95	106	destabilize	10	9	19
3K1H3NEY7L0T32SNPWQ791M1KLPGD6	Tensions stemming from the Syrian uprising also have touched off clashes across the border in Lebanon, in the northern city of Tripoli.	0	17	Tensions stemming	1	0	1
3K1H3NEY7L0T32SNPWQ791M1KLPGD6	Tensions stemming from the Syrian uprising also have touched off clashes across the border in Lebanon, in the northern city of Tripoli.	9	17	stemming	10	10	20
3K1H3NEY7L0T32SNPWQ791M1KLPGD6	Tensions stemming from the Syrian uprising also have touched off clashes across the border in Lebanon, in the northern city of Tripoli.	34	42	uprising	2	2	4
3K1H3NEY7L0T32SNPWQ791M1KLPGD6	Tensions stemming from the Syrian uprising also have touched off clashes across the border in Lebanon, in the northern city of Tripoli.	53	64	touched off	2	2	4
3K1H3NEY7L0T32SNPWQ791M1KLPGD6	Tensions stemming from the Syrian uprising also have touched off clashes across the border in Lebanon, in the northern city of Tripoli.	65	72	clashes	2	2	4
3K1H3NEY7L0T32SNPWQ791M1KLPGD6	Street battles pitting Lebanese Sunnis — who generally support the Syrian uprising — against Alawite supporters of Assad's regime killed one person Monday, raising the death toll to four since Sunday.	0	14	Street battles	0	1	1
3K1H3NEY7L0T32SNPWQ791M1KLPGD6	Street battles pitting Lebanese Sunnis — who generally support the Syrian uprising — against Alawite supporters of Assad's regime killed one person Monday, raising the death toll to four since Sunday.	7	14	battles	1	0	1
3K1H3NEY7L0T32SNPWQ791M1KLPGD6	Street battles pitting Lebanese Sunnis — who generally support the Syrian uprising — against Alawite supporters of Assad's regime killed one person Monday, raising the death toll to four since Sunday.	15	22	pitting	3	8	11
3K1H3NEY7L0T32SNPWQ791M1KLPGD6	Street battles pitting Lebanese Sunnis — who generally support the Syrian uprising — against Alawite supporters of Assad's regime killed one person Monday, raising the death toll to four since Sunday.	23	31	Lebanese	1	0	1
3K1H3NEY7L0T32SNPWQ791M1KLPGD6	Street battles pitting Lebanese Sunnis — who generally support the Syrian uprising — against Alawite supporters of Assad's regime killed one person Monday, raising the death toll to four since Sunday.	23	38	Lebanese Sunnis	1	0	1
3K1H3NEY7L0T32SNPWQ791M1KLPGD6	Street battles pitting Lebanese Sunnis — who generally support the Syrian uprising — against Alawite supporters of Assad's regime killed one person Monday, raising the death toll to four since Sunday.	74	82	uprising	3	3	6
3K1H3NEY7L0T32SNPWQ791M1KLPGD6	Street battles pitting Lebanese Sunnis — who generally support the Syrian uprising — against Alawite supporters of Assad's regime killed one person Monday, raising the death toll to four since Sunday.	93	100	Alawite	1	1	2
3K1H3NEY7L0T32SNPWQ791M1KLPGD6	Street battles pitting Lebanese Sunnis — who generally support the Syrian uprising — against Alawite supporters of Assad's regime killed one person Monday, raising the death toll to four since Sunday.	123	129	regime	7	4	11
3K1H3NEY7L0T32SNPWQ791M1KLPGD6	Street battles pitting Lebanese Sunnis — who generally support the Syrian uprising — against Alawite supporters of Assad's regime killed one person Monday, raising the death toll to four since Sunday.	156	163	raising	1	0	1
3K1H3NEY7L0T32SNPWQ791M1KLPGD6	Street battles pitting Lebanese Sunnis — who generally support the Syrian uprising — against Alawite supporters of Assad's regime killed one person Monday, raising the death toll to four since Sunday.	168	178	death toll	0	1	1
3K1H3NEY7L0T32SNPWQ791M1KLPGD6	Street battles pitting Lebanese Sunnis — who generally support the Syrian uprising — against Alawite supporters of Assad's regime killed one person Monday, raising the death toll to four since Sunday.	174	178	toll	0	1	1
3K1H3NEY7L0T32SNPWQ791M1KLPGD6	The clashes began Sunday after authorities detained an anti-Syrian Lebanese national.	31	42	authorities	0	1	1
3K1H3NEY7L0T32SNPWQ791M1KLPGD6	The clashes began Sunday after authorities detained an anti-Syrian Lebanese national.	43	51	detained	10	6	16
3K1H3NEY7L0T32SNPWQ791M1KLPGD6	The clashes began Sunday after authorities detained an anti-Syrian Lebanese national.	76	84	national	3	0	3
3K1H3NEY7L0T32SNPWQ791M1KLPGD6	The violence further undermines a U.N.-backed peace plan that is supposed to bring an end to Syria's deadly crisis.	4	12	violence	0	1	1
3K1H3NEY7L0T32SNPWQ791M1KLPGD6	The violence further undermines a U.N.-backed peace plan that is supposed to bring an end to Syria's deadly crisis.	21	31	undermines	10	8	18
3K1H3NEY7L0T32SNPWQ791M1KLPGD6	The violence further undermines a U.N.-backed peace plan that is supposed to bring an end to Syria's deadly crisis.	34	56	U.N.-backed peace plan	0	1	1
3K1H3NEY7L0T32SNPWQ791M1KLPGD6	The violence further undermines a U.N.-backed peace plan that is supposed to bring an end to Syria's deadly crisis.	65	73	supposed	1	0	1
3K1H3NEY7L0T32SNPWQ791M1KLPGD6	The violence further undermines a U.N.-backed peace plan that is supposed to bring an end to Syria's deadly crisis.	101	114	deadly crisis	1	1	2
3K1H3NEY7L0T32SNPWQ791M1KLPGD6	The violence further undermines a U.N.-backed peace plan that is supposed to bring an end to Syria's deadly crisis.	108	114	crisis	3	1	4
3K1H3NEY7L0T32SNPWQ791M1KLPGD6	A cease-fire that was supposed to begin on April 12 has had only a limited effect, throwing into doubt the rest of the plan that calls for talks between Assad's regime and those seeking to end his rule.	2	12	cease-fire	7	8	15
3K1H3NEY7L0T32SNPWQ791M1KLPGD6	A cease-fire that was supposed to begin on April 12 has had only a limited effect, throwing into doubt the rest of the plan that calls for talks between Assad's regime and those seeking to end his rule.	67	81	limited effect	1	0	1
3K1H3NEY7L0T32SNPWQ791M1KLPGD6	A cease-fire that was supposed to begin on April 12 has had only a limited effect, throwing into doubt the rest of the plan that calls for talks between Assad's regime and those seeking to end his rule.	161	167	regime	8	0	8
3AJA9FLWSCZ4XDCE6QL0ID22BBXIFB	Al Jazeera's Sonia Gallego, reporting from Madrid, said the nationalisation of other banks should not be ruled out as an option yet.	60	75	nationalisation	10	8	18
3AJA9FLWSCZ4XDCE6QL0ID22BBXIFB	Al Jazeera's Sonia Gallego, reporting from Madrid, said the nationalisation of other banks should not be ruled out as an option yet.	60	90	nationalisation of other banks	1	0	1
3AJA9FLWSCZ4XDCE6QL0ID22BBXIFB	Al Jazeera's Sonia Gallego, reporting from Madrid, said the nationalisation of other banks should not be ruled out as an option yet.	105	114	ruled out	0	4	4
3AJA9FLWSCZ4XDCE6QL0ID22BBXIFB	Al Jazeera's Sonia Gallego, reporting from Madrid, said the nationalisation of other banks should not be ruled out as an option yet.	121	127	option	0	1	1
3AJA9FLWSCZ4XDCE6QL0ID22BBXIFB	"With the gravity of the economic situation [in Spain], it is getting increasingly difficult" for the government to refinance as much of the debt as it can, she said.	10	17	gravity	6	5	11
3AJA9FLWSCZ4XDCE6QL0ID22BBXIFB	"With the gravity of the economic situation [in Spain], it is getting increasingly difficult" for the government to refinance as much of the debt as it can, she said.	10	43	gravity of the economic situation	2	0	2
3AJA9FLWSCZ4XDCE6QL0ID22BBXIFB	"With the gravity of the economic situation [in Spain], it is getting increasingly difficult" for the government to refinance as much of the debt as it can, she said.	25	43	economic situation	1	0	1
3AJA9FLWSCZ4XDCE6QL0ID22BBXIFB	"With the gravity of the economic situation [in Spain], it is getting increasingly difficult" for the government to refinance as much of the debt as it can, she said.	70	92	increasingly difficult	0	1	1
3AJA9FLWSCZ4XDCE6QL0ID22BBXIFB	"With the gravity of the economic situation [in Spain], it is getting increasingly difficult" for the government to refinance as much of the debt as it can, she said.	116	125	refinance	10	8	18
3AJA9FLWSCZ4XDCE6QL0ID22BBXIFB	"With the gravity of the economic situation [in Spain], it is getting increasingly difficult" for the government to refinance as much of the debt as it can, she said.	116	145	refinance as much of the debt	1	0	1
3AJA9FLWSCZ4XDCE6QL0ID22BBXIFB	"With the gravity of the economic situation [in Spain], it is getting increasingly difficult" for the government to refinance as much of the debt as it can, she said.	141	145	debt	1	1	2
3AJA9FLWSCZ4XDCE6QL0ID22BBXIFB	Spain effectively took over Bankia SA, one of the country's biggest banks, this week after days of market anxiety over the lender's viability.	6	17	effectively	1	0	1
3AJA9FLWSCZ4XDCE6QL0ID22BBXIFB	Spain effectively took over Bankia SA, one of the country's biggest banks, this week after days of market anxiety over the lender's viability.	6	27	effectively took over	1	0	1
3AJA9FLWSCZ4XDCE6QL0ID22BBXIFB	Spain effectively took over Bankia SA, one of the country's biggest banks, this week after days of market anxiety over the lender's viability.	99	113	market anxiety	4	4	8
3AJA9FLWSCZ4XDCE6QL0ID22BBXIFB	Spain effectively took over Bankia SA, one of the country's biggest banks, this week after days of market anxiety over the lender's viability.	106	113	anxiety	3	3	6
3AJA9FLWSCZ4XDCE6QL0ID22BBXIFB	Spain effectively took over Bankia SA, one of the country's biggest banks, this week after days of market anxiety over the lender's viability.	106	140	anxiety over the lenders viability	1	0	1
3AJA9FLWSCZ4XDCE6QL0ID22BBXIFB	Spain effectively took over Bankia SA, one of the country's biggest banks, this week after days of market anxiety over the lender's viability.	123	130	lenders	0	2	2
3AJA9FLWSCZ4XDCE6QL0ID22BBXIFB	Spain effectively took over Bankia SA, one of the country's biggest banks, this week after days of market anxiety over the lender's viability.	123	140	lenders viability	2	3	5
3AJA9FLWSCZ4XDCE6QL0ID22BBXIFB	Spain effectively took over Bankia SA, one of the country's biggest banks, this week after days of market anxiety over the lender's viability.	132	141	viability	7	6	13
3AJA9FLWSCZ4XDCE6QL0ID22BBXIFB	Toxic assets Spain's banks were hit by billions of euros of losses after a decade-long property bubble burst in 2008 and concerns about them, and the country's overspending regional governments have fanned fears of a new eurozone debt crisis.	0	5	Toxic	0	2	2
3AJA9FLWSCZ4XDCE6QL0ID22BBXIFB	Toxic assets Spain's banks were hit by billions of euros of losses after a decade-long property bubble burst in 2008 and concerns about them, and the country's overspending regional governments have fanned fears of a new eurozone debt crisis.	0	12	Toxic assets	5	2	7
3AJA9FLWSCZ4XDCE6QL0ID22BBXIFB	Toxic assets Spain's banks were hit by billions of euros of losses after a decade-long property bubble burst in 2008 and concerns about them, and the country's overspending regional governments have fanned fears of a new eurozone debt crisis.	6	12	assets	2	1	3
3AJA9FLWSCZ4XDCE6QL0ID22BBXIFB	Toxic assets Spain's banks were hit by billions of euros of losses after a decade-long property bubble burst in 2008 and concerns about them, and the country's overspending regional governments have fanned fears of a new eurozone debt crisis.	75	86	decade-long	3	4	7
3AJA9FLWSCZ4XDCE6QL0ID22BBXIFB	Toxic assets Spain's banks were hit by billions of euros of losses after a decade-long property bubble burst in 2008 and concerns about them, and the country's overspending regional governments have fanned fears of a new eurozone debt crisis.	87	102	property bubble	3	1	4
3AJA9FLWSCZ4XDCE6QL0ID22BBXIFB	Toxic assets Spain's banks were hit by billions of euros of losses after a decade-long property bubble burst in 2008 and concerns about them, and the country's overspending regional governments have fanned fears of a new eurozone debt crisis.	87	108	property bubble burst	3	2	5
3AJA9FLWSCZ4XDCE6QL0ID22BBXIFB	Toxic assets Spain's banks were hit by billions of euros of losses after a decade-long property bubble burst in 2008 and concerns about them, and the country's overspending regional governments have fanned fears of a new eurozone debt crisis.	96	102	bubble	1	1	2
3AJA9FLWSCZ4XDCE6QL0ID22BBXIFB	Toxic assets Spain's banks were hit by billions of euros of losses after a decade-long property bubble burst in 2008 and concerns about them, and the country's overspending regional governments have fanned fears of a new eurozone debt crisis.	96	108	bubble burst	0	3	3
3AJA9FLWSCZ4XDCE6QL0ID22BBXIFB	Toxic assets Spain's banks were hit by billions of euros of losses after a decade-long property bubble burst in 2008 and concerns about them, and the country's overspending regional governments have fanned fears of a new eurozone debt crisis.	103	108	burst	0	2	2
3AJA9FLWSCZ4XDCE6QL0ID22BBXIFB	Toxic assets Spain's banks were hit by billions of euros of losses after a decade-long property bubble burst in 2008 and concerns about them, and the country's overspending regional governments have fanned fears of a new eurozone debt crisis.	150	192	countrys overspending regional governments	1	0	1
3AJA9FLWSCZ4XDCE6QL0ID22BBXIFB	Toxic assets Spain's banks were hit by billions of euros of losses after a decade-long property bubble burst in 2008 and concerns about them, and the country's overspending regional governments have fanned fears of a new eurozone debt crisis.	160	172	overspending	4	7	11
3AJA9FLWSCZ4XDCE6QL0ID22BBXIFB	Toxic assets Spain's banks were hit by billions of euros of losses after a decade-long property bubble burst in 2008 and concerns about them, and the country's overspending regional governments have fanned fears of a new eurozone debt crisis.	199	205	fanned	5	7	12
3AJA9FLWSCZ4XDCE6QL0ID22BBXIFB	Toxic assets Spain's banks were hit by billions of euros of losses after a decade-long property bubble burst in 2008 and concerns about them, and the country's overspending regional governments have fanned fears of a new eurozone debt crisis.	199	211	fanned fears	1	3	4
3AJA9FLWSCZ4XDCE6QL0ID22BBXIFB	Toxic assets Spain's banks were hit by billions of euros of losses after a decade-long property bubble burst in 2008 and concerns about them, and the country's overspending regional governments have fanned fears of a new eurozone debt crisis.	221	229	eurozone	4	2	6
3AJA9FLWSCZ4XDCE6QL0ID22BBXIFB	Toxic assets Spain's banks were hit by billions of euros of losses after a decade-long property bubble burst in 2008 and concerns about them, and the country's overspending regional governments have fanned fears of a new eurozone debt crisis.	221	241	eurozone debt crisis	1	0	1
3AJA9FLWSCZ4XDCE6QL0ID22BBXIFB	Toxic assets Spain's banks were hit by billions of euros of losses after a decade-long property bubble burst in 2008 and concerns about them, and the country's overspending regional governments have fanned fears of a new eurozone debt crisis.	230	234	debt	1	0	1
3AJA9FLWSCZ4XDCE6QL0ID22BBXIFB	Toxic assets Spain's banks were hit by billions of euros of losses after a decade-long property bubble burst in 2008 and concerns about them, and the country's overspending regional governments have fanned fears of a new eurozone debt crisis.	230	241	debt crisis	1	2	3
3AJA9FLWSCZ4XDCE6QL0ID22BBXIFB	Toxic assets Spain's banks were hit by billions of euros of losses after a decade-long property bubble burst in 2008 and concerns about them, and the country's overspending regional governments have fanned fears of a new eurozone debt crisis.	235	241	crisis	1	3	4
3AJA9FLWSCZ4XDCE6QL0ID22BBXIFB	Toxic assets now total 184 billion euros, but many fear the hole is even bigger.	0	12	Toxic assets	5	2	7
3AJA9FLWSCZ4XDCE6QL0ID22BBXIFB	Toxic assets now total 184 billion euros, but many fear the hole is even bigger.	6	12	assets	1	0	1
3AJA9FLWSCZ4XDCE6QL0ID22BBXIFB	Toxic assets now total 184 billion euros, but many fear the hole is even bigger.	51	64	fear the hole	1	0	1
3ZXNP4Z39RMT8L5E9AK1M1HDU3N7LD	On the anniversary of bin Laden's killing, Crocker said he did not believe there would be a sole turning point in the war.	7	18	anniversary	4	4	8
3ZXNP4Z39RMT8L5E9AK1M1HDU3N7LD	On the anniversary of bin Laden's killing, Crocker said he did not believe there would be a sole turning point in the war.	43	50	Crocker	0	3	3
3ZXNP4Z39RMT8L5E9AK1M1HDU3N7LD	On the anniversary of bin Laden's killing, Crocker said he did not believe there would be a sole turning point in the war.	92	96	sole	5	5	10
3ZXNP4Z39RMT8L5E9AK1M1HDU3N7LD	On the anniversary of bin Laden's killing, Crocker said he did not believe there would be a sole turning point in the war.	92	104	sole turning	0	1	1
3ZXNP4Z39RMT8L5E9AK1M1HDU3N7LD	On the anniversary of bin Laden's killing, Crocker said he did not believe there would be a sole turning point in the war.	92	110	sole turning point	3	3	6
3ZXNP4Z39RMT8L5E9AK1M1HDU3N7LD	On the anniversary of bin Laden's killing, Crocker said he did not believe there would be a sole turning point in the war.	97	110	turning point	1	2	3
3ZXNP4Z39RMT8L5E9AK1M1HDU3N7LD	We do feel we are prevailing in this with our Afghan partners," he said.	18	28	prevailing	10	10	20
3ZXNP4Z39RMT8L5E9AK1M1HDU3N7LD	We do feel we are prevailing in this with our Afghan partners," he said.	18	36	prevailing in this	1	0	1
3ZXNP4Z39RMT8L5E9AK1M1HDU3N7LD	We do feel we are prevailing in this with our Afghan partners," he said.	53	61	partners	1	0	1
3ZXNP4Z39RMT8L5E9AK1M1HDU3N7LD	"We cannot be in a position of taking on ourselves bringing perfection to Afghanistan.	19	27	position	0	1	1
3ZXNP4Z39RMT8L5E9AK1M1HDU3N7LD	"We cannot be in a position of taking on ourselves bringing perfection to Afghanistan.	31	73	taking on ourselves bringing perfection to	1	0	1
3ZXNP4Z39RMT8L5E9AK1M1HDU3N7LD	"We cannot be in a position of taking on ourselves bringing perfection to Afghanistan.	51	70	bringing perfection	1	1	2
3ZXNP4Z39RMT8L5E9AK1M1HDU3N7LD	"We cannot be in a position of taking on ourselves bringing perfection to Afghanistan.	60	70	perfection	3	2	5
3ZXNP4Z39RMT8L5E9AK1M1HDU3N7LD	"We cannot be in a position of taking on ourselves bringing perfection to Afghanistan.	74	85	Afghanistan	1	0	1
3ZXNP4Z39RMT8L5E9AK1M1HDU3N7LD	That has to be left to Afghans."	15	19	left	1	0	1
3ZXNP4Z39RMT8L5E9AK1M1HDU3N7LD	That has to be left to Afghans."	15	30	left to Afghans	1	0	1
3ZXNP4Z39RMT8L5E9AK1M1HDU3N7LD	But Crocker said there would be no repeat of the 1990s when a withdrawal of Western backers in the wake of the Soviet withdrawal unleashed a vicious civil war out of which the Taliban and al Qaeda support bases arose.	35	41	repeat	0	1	1
3ZXNP4Z39RMT8L5E9AK1M1HDU3N7LD	But Crocker said there would be no repeat of the 1990s when a withdrawal of Western backers in the wake of the Soviet withdrawal unleashed a vicious civil war out of which the Taliban and al Qaeda support bases arose.	62	72	withdrawal	6	8	14
3ZXNP4Z39RMT8L5E9AK1M1HDU3N7LD	But Crocker said there would be no repeat of the 1990s when a withdrawal of Western backers in the wake of the Soviet withdrawal unleashed a vicious civil war out of which the Taliban and al Qaeda support bases arose.	76	91	Western backers	2	0	2
3ZXNP4Z39RMT8L5E9AK1M1HDU3N7LD	But Crocker said there would be no repeat of the 1990s when a withdrawal of Western backers in the wake of the Soviet withdrawal unleashed a vicious civil war out of which the Taliban and al Qaeda support bases arose.	84	91	backers	3	5	8
3ZXNP4Z39RMT8L5E9AK1M1HDU3N7LD	But Crocker said there would be no repeat of the 1990s when a withdrawal of Western backers in the wake of the Soviet withdrawal unleashed a vicious civil war out of which the Taliban and al Qaeda support bases arose.	92	106	in the wake of	1	0	1
3ZXNP4Z39RMT8L5E9AK1M1HDU3N7LD	But Crocker said there would be no repeat of the 1990s when a withdrawal of Western backers in the wake of the Soviet withdrawal unleashed a vicious civil war out of which the Taliban and al Qaeda support bases arose.	118	128	withdrawal	0	2	2
3ZXNP4Z39RMT8L5E9AK1M1HDU3N7LD	But Crocker said there would be no repeat of the 1990s when a withdrawal of Western backers in the wake of the Soviet withdrawal unleashed a vicious civil war out of which the Taliban and al Qaeda support bases arose.	129	138	unleashed	8	10	18
3ZXNP4Z39RMT8L5E9AK1M1HDU3N7LD	But Crocker said there would be no repeat of the 1990s when a withdrawal of Western backers in the wake of the Soviet withdrawal unleashed a vicious civil war out of which the Taliban and al Qaeda support bases arose.	141	148	vicious	6	8	14
3ZXNP4Z39RMT8L5E9AK1M1HDU3N7LD	But Crocker said there would be no repeat of the 1990s when a withdrawal of Western backers in the wake of the Soviet withdrawal unleashed a vicious civil war out of which the Taliban and al Qaeda support bases arose.	141	158	vicious civil war	1	2	3
3ZXNP4Z39RMT8L5E9AK1M1HDU3N7LD	But Crocker said there would be no repeat of the 1990s when a withdrawal of Western backers in the wake of the Soviet withdrawal unleashed a vicious civil war out of which the Taliban and al Qaeda support bases arose.	188	196	al Qaeda	0	1	1
3ZXNP4Z39RMT8L5E9AK1M1HDU3N7LD	But Crocker said there would be no repeat of the 1990s when a withdrawal of Western backers in the wake of the Soviet withdrawal unleashed a vicious civil war out of which the Taliban and al Qaeda support bases arose.	197	210	support bases	1	0	1
3ZXNP4Z39RMT8L5E9AK1M1HDU3N7LD	But Crocker said there would be no repeat of the 1990s when a withdrawal of Western backers in the wake of the Soviet withdrawal unleashed a vicious civil war out of which the Taliban and al Qaeda support bases arose.	205	210	bases	0	1	1
3ZXNP4Z39RMT8L5E9AK1M1HDU3N7LD	But Crocker said there would be no repeat of the 1990s when a withdrawal of Western backers in the wake of the Soviet withdrawal unleashed a vicious civil war out of which the Taliban and al Qaeda support bases arose.	205	216	bases arose	1	0	1
3ZXNP4Z39RMT8L5E9AK1M1HDU3N7LD	But Crocker said there would be no repeat of the 1990s when a withdrawal of Western backers in the wake of the Soviet withdrawal unleashed a vicious civil war out of which the Taliban and al Qaeda support bases arose.	211	216	arose	4	1	5
3ZXNP4Z39RMT8L5E9AK1M1HDU3N7LD	Just hours after President Obama’s plane lifted off from Afghanistan, a bomb rocked Kabul, killing at least seven, a vivid reminder of the challenges that still lay ahead for the country.	41	51	lifted off	1	1	2
3ZXNP4Z39RMT8L5E9AK1M1HDU3N7LD	Just hours after President Obama’s plane lifted off from Afghanistan, a bomb rocked Kabul, killing at least seven, a vivid reminder of the challenges that still lay ahead for the country.	57	68	Afghanistan	1	0	1
3ZXNP4Z39RMT8L5E9AK1M1HDU3N7LD	Just hours after President Obama’s plane lifted off from Afghanistan, a bomb rocked Kabul, killing at least seven, a vivid reminder of the challenges that still lay ahead for the country.	77	83	rocked	2	2	4
3ZXNP4Z39RMT8L5E9AK1M1HDU3N7LD	Just hours after President Obama’s plane lifted off from Afghanistan, a bomb rocked Kabul, killing at least seven, a vivid reminder of the challenges that still lay ahead for the country.	117	122	vivid	8	7	15
3ZXNP4Z39RMT8L5E9AK1M1HDU3N7LD	Just hours after President Obama’s plane lifted off from Afghanistan, a bomb rocked Kabul, killing at least seven, a vivid reminder of the challenges that still lay ahead for the country.	117	131	vivid reminder	1	1	2
3ZXNP4Z39RMT8L5E9AK1M1HDU3N7LD	Just hours after President Obama’s plane lifted off from Afghanistan, a bomb rocked Kabul, killing at least seven, a vivid reminder of the challenges that still lay ahead for the country.	139	149	challenges	2	2	4
3ZXNP4Z39RMT8L5E9AK1M1HDU3N7LD	Just hours after President Obama’s plane lifted off from Afghanistan, a bomb rocked Kabul, killing at least seven, a vivid reminder of the challenges that still lay ahead for the country.	161	170	lay ahead	1	0	1
344M16OZKIG450N98VEM53DJL9CNEE	"The general feeling is that Spanish banks have worse problems than previously thought," said Edward Hugh, an independent economist based in Barcelona.	48	53	worse	1	2	3
344M16OZKIG450N98VEM53DJL9CNEE	"The general feeling is that Spanish banks have worse problems than previously thought," said Edward Hugh, an independent economist based in Barcelona.	48	62	worse problems	0	1	1
344M16OZKIG450N98VEM53DJL9CNEE	"The general feeling is that Spanish banks have worse problems than previously thought," said Edward Hugh, an independent economist based in Barcelona.	68	78	previously	2	1	3
344M16OZKIG450N98VEM53DJL9CNEE	"The general feeling is that Spanish banks have worse problems than previously thought," said Edward Hugh, an independent economist based in Barcelona.	68	86	previously thought	1	0	1
344M16OZKIG450N98VEM53DJL9CNEE	"The general feeling is that Spanish banks have worse problems than previously thought," said Edward Hugh, an independent economist based in Barcelona.	110	121	independent	0	1	1
344M16OZKIG450N98VEM53DJL9CNEE	"The general feeling is that Spanish banks have worse problems than previously thought," said Edward Hugh, an independent economist based in Barcelona.	110	131	independent economist	6	0	6
344M16OZKIG450N98VEM53DJL9CNEE	"The general feeling is that Spanish banks have worse problems than previously thought," said Edward Hugh, an independent economist based in Barcelona.	122	131	economist	5	2	7
344M16OZKIG450N98VEM53DJL9CNEE	In an attempt to soothe markets, the government has said it will approve a reform enabling banks to transfer problem loans to separate agencies.	6	13	attempt	0	3	3
344M16OZKIG450N98VEM53DJL9CNEE	In an attempt to soothe markets, the government has said it will approve a reform enabling banks to transfer problem loans to separate agencies.	17	23	soothe	7	10	17
344M16OZKIG450N98VEM53DJL9CNEE	In an attempt to soothe markets, the government has said it will approve a reform enabling banks to transfer problem loans to separate agencies.	17	31	soothe markets	1	0	1
344M16OZKIG450N98VEM53DJL9CNEE	In an attempt to soothe markets, the government has said it will approve a reform enabling banks to transfer problem loans to separate agencies.	75	81	reform	5	4	9
344M16OZKIG450N98VEM53DJL9CNEE	In an attempt to soothe markets, the government has said it will approve a reform enabling banks to transfer problem loans to separate agencies.	75	90	reform enabling	0	1	1
344M16OZKIG450N98VEM53DJL9CNEE	In an attempt to soothe markets, the government has said it will approve a reform enabling banks to transfer problem loans to separate agencies.	75	96	reform enabling banks	1	0	1
344M16OZKIG450N98VEM53DJL9CNEE	In an attempt to soothe markets, the government has said it will approve a reform enabling banks to transfer problem loans to separate agencies.	82	90	enabling	6	4	10
344M16OZKIG450N98VEM53DJL9CNEE	In an attempt to soothe markets, the government has said it will approve a reform enabling banks to transfer problem loans to separate agencies.	109	122	problem loans	2	0	2
344M16OZKIG450N98VEM53DJL9CNEE	In an attempt to soothe markets, the government has said it will approve a reform enabling banks to transfer problem loans to separate agencies.	135	143	agencies	3	1	4
344M16OZKIG450N98VEM53DJL9CNEE	But it has said this will be done without using state money.	48	59	state money	2	1	3
344M16OZKIG450N98VEM53DJL9CNEE	"What we want is to fix the real price of homes (held by the banks) even if everyone loses money, the developers as well as the banks, and that we put them on sale," Rajoy said this week.	102	112	developers	4	4	8
344M16OZKIG450N98VEM53DJL9CNEE	"What we want is to fix the real price of homes (held by the banks) even if everyone loses money, the developers as well as the banks, and that we put them on sale," Rajoy said this week.	166	171	Rajoy	0	1	1
344M16OZKIG450N98VEM53DJL9CNEE	The second plank of the reform will be a requirement that banks boost a financial cushion against the threat of losses in their property assets, the Economy Ministry has said.	4	16	second plank	2	0	2
344M16OZKIG450N98VEM53DJL9CNEE	The second plank of the reform will be a requirement that banks boost a financial cushion against the threat of losses in their property assets, the Economy Ministry has said.	11	16	plank	7	10	17
344M16OZKIG450N98VEM53DJL9CNEE	The second plank of the reform will be a requirement that banks boost a financial cushion against the threat of losses in their property assets, the Economy Ministry has said.	11	30	plank of the reform	1	0	1
344M16OZKIG450N98VEM53DJL9CNEE	The second plank of the reform will be a requirement that banks boost a financial cushion against the threat of losses in their property assets, the Economy Ministry has said.	24	30	reform	5	1	6
344M16OZKIG450N98VEM53DJL9CNEE	The second plank of the reform will be a requirement that banks boost a financial cushion against the threat of losses in their property assets, the Economy Ministry has said.	41	52	requirement	3	3	6
344M16OZKIG450N98VEM53DJL9CNEE	The second plank of the reform will be a requirement that banks boost a financial cushion against the threat of losses in their property assets, the Economy Ministry has said.	64	69	boost	1	5	6
344M16OZKIG450N98VEM53DJL9CNEE	The second plank of the reform will be a requirement that banks boost a financial cushion against the threat of losses in their property assets, the Economy Ministry has said.	64	89	boost a financial cushion	1	0	1
344M16OZKIG450N98VEM53DJL9CNEE	The second plank of the reform will be a requirement that banks boost a financial cushion against the threat of losses in their property assets, the Economy Ministry has said.	72	89	financial cushion	10	4	14
344M16OZKIG450N98VEM53DJL9CNEE	The second plank of the reform will be a requirement that banks boost a financial cushion against the threat of losses in their property assets, the Economy Ministry has said.	82	89	cushion	0	3	3
344M16OZKIG450N98VEM53DJL9CNEE	The second plank of the reform will be a requirement that banks boost a financial cushion against the threat of losses in their property assets, the Economy Ministry has said.	102	108	threat	0	1	1
344M16OZKIG450N98VEM53DJL9CNEE	The second plank of the reform will be a requirement that banks boost a financial cushion against the threat of losses in their property assets, the Economy Ministry has said.	102	118	threat of losses	1	0	1
344M16OZKIG450N98VEM53DJL9CNEE	The second plank of the reform will be a requirement that banks boost a financial cushion against the threat of losses in their property assets, the Economy Ministry has said.	128	143	property assets	6	1	7
344M16OZKIG450N98VEM53DJL9CNEE	The second plank of the reform will be a requirement that banks boost a financial cushion against the threat of losses in their property assets, the Economy Ministry has said.	137	143	assets	2	4	6
344M16OZKIG450N98VEM53DJL9CNEE	The second plank of the reform will be a requirement that banks boost a financial cushion against the threat of losses in their property assets, the Economy Ministry has said.	149	165	Economy Ministry	1	0	1
3E22YV8GG1782RCZH9UXZFCN0THPNV	The thousands of Russians who rallied in Moscow and St. Petersburg faced off with police and Interior Ministry troops, who detained hundreds of protesters, including journalists.	4	13	thousands	1	0	1
3E22YV8GG1782RCZH9UXZFCN0THPNV	The thousands of Russians who rallied in Moscow and St. Petersburg faced off with police and Interior Ministry troops, who detained hundreds of protesters, including journalists.	30	37	rallied	4	6	10
3E22YV8GG1782RCZH9UXZFCN0THPNV	The thousands of Russians who rallied in Moscow and St. Petersburg faced off with police and Interior Ministry troops, who detained hundreds of protesters, including journalists.	67	76	faced off	1	2	3
3E22YV8GG1782RCZH9UXZFCN0THPNV	The thousands of Russians who rallied in Moscow and St. Petersburg faced off with police and Interior Ministry troops, who detained hundreds of protesters, including journalists.	93	101	Interior	1	1	2
3E22YV8GG1782RCZH9UXZFCN0THPNV	The thousands of Russians who rallied in Moscow and St. Petersburg faced off with police and Interior Ministry troops, who detained hundreds of protesters, including journalists.	93	117	Interior Ministry troops	4	0	4
3E22YV8GG1782RCZH9UXZFCN0THPNV	The thousands of Russians who rallied in Moscow and St. Petersburg faced off with police and Interior Ministry troops, who detained hundreds of protesters, including journalists.	123	131	detained	10	10	20
3E22YV8GG1782RCZH9UXZFCN0THPNV	The thousands of Russians who rallied in Moscow and St. Petersburg faced off with police and Interior Ministry troops, who detained hundreds of protesters, including journalists.	144	154	protesters	5	4	9
3E22YV8GG1782RCZH9UXZFCN0THPNV	The thousands of Russians who rallied in Moscow and St. Petersburg faced off with police and Interior Ministry troops, who detained hundreds of protesters, including journalists.	166	177	journalists	2	0	2
3E22YV8GG1782RCZH9UXZFCN0THPNV	The Russian Union of Journalists on Wednesday condemned police violence and called for a probe into the dozens of attacks and arrests of journalists, describing them as "an attempt to gag and intimidate society."	4	32	Russian Union of Journalists	1	0	1
3E22YV8GG1782RCZH9UXZFCN0THPNV	The Russian Union of Journalists on Wednesday condemned police violence and called for a probe into the dozens of attacks and arrests of journalists, describing them as "an attempt to gag and intimidate society."	46	55	condemned	10	10	20
3E22YV8GG1782RCZH9UXZFCN0THPNV	The Russian Union of Journalists on Wednesday condemned police violence and called for a probe into the dozens of attacks and arrests of journalists, describing them as "an attempt to gag and intimidate society."	63	71	violence	0	2	2
3E22YV8GG1782RCZH9UXZFCN0THPNV	The Russian Union of Journalists on Wednesday condemned police violence and called for a probe into the dozens of attacks and arrests of journalists, describing them as "an attempt to gag and intimidate society."	89	94	probe	6	4	10
3E22YV8GG1782RCZH9UXZFCN0THPNV	The Russian Union of Journalists on Wednesday condemned police violence and called for a probe into the dozens of attacks and arrests of journalists, describing them as "an attempt to gag and intimidate society."	150	160	describing	0	1	1
3E22YV8GG1782RCZH9UXZFCN0THPNV	The Russian Union of Journalists on Wednesday condemned police violence and called for a probe into the dozens of attacks and arrests of journalists, describing them as "an attempt to gag and intimidate society."	173	187	attempt to gag	0	1	1
3E22YV8GG1782RCZH9UXZFCN0THPNV	The Russian Union of Journalists on Wednesday condemned police violence and called for a probe into the dozens of attacks and arrests of journalists, describing them as "an attempt to gag and intimidate society."	184	187	gag	5	7	12
3E22YV8GG1782RCZH9UXZFCN0THPNV	The Russian Union of Journalists on Wednesday condemned police violence and called for a probe into the dozens of attacks and arrests of journalists, describing them as "an attempt to gag and intimidate society."	184	202	gag and intimidate	1	1	2
3E22YV8GG1782RCZH9UXZFCN0THPNV	The Russian Union of Journalists on Wednesday condemned police violence and called for a probe into the dozens of attacks and arrests of journalists, describing them as "an attempt to gag and intimidate society."	192	202	intimidate	10	5	15
3E22YV8GG1782RCZH9UXZFCN0THPNV	The Russian Union of Journalists on Wednesday condemned police violence and called for a probe into the dozens of attacks and arrests of journalists, describing them as "an attempt to gag and intimidate society."	192	210	intimidate society	1	2	3
3E22YV8GG1782RCZH9UXZFCN0THPNV	The Russian Union of Journalists on Wednesday condemned police violence and called for a probe into the dozens of attacks and arrests of journalists, describing them as "an attempt to gag and intimidate society."	203	210	society	1	0	1
3E22YV8GG1782RCZH9UXZFCN0THPNV	More opposition rallies were expected Wednesday, along with a pro-Putin gathering in central Moscow that had attracted a few hundred people so far.	5	15	opposition	6	0	6
3E22YV8GG1782RCZH9UXZFCN0THPNV	More opposition rallies were expected Wednesday, along with a pro-Putin gathering in central Moscow that had attracted a few hundred people so far.	5	23	opposition rallies	2	0	2
3E22YV8GG1782RCZH9UXZFCN0THPNV	More opposition rallies were expected Wednesday, along with a pro-Putin gathering in central Moscow that had attracted a few hundred people so far.	16	23	rallies	0	1	1
3E22YV8GG1782RCZH9UXZFCN0THPNV	More opposition rallies were expected Wednesday, along with a pro-Putin gathering in central Moscow that had attracted a few hundred people so far.	29	37	expected	1	1	2
3E22YV8GG1782RCZH9UXZFCN0THPNV	More opposition rallies were expected Wednesday, along with a pro-Putin gathering in central Moscow that had attracted a few hundred people so far.	62	71	pro-Putin	1	0	1
3E22YV8GG1782RCZH9UXZFCN0THPNV	More opposition rallies were expected Wednesday, along with a pro-Putin gathering in central Moscow that had attracted a few hundred people so far.	62	81	pro-Putin gathering	2	2	4
3E22YV8GG1782RCZH9UXZFCN0THPNV	More opposition rallies were expected Wednesday, along with a pro-Putin gathering in central Moscow that had attracted a few hundred people so far.	72	81	gathering	0	2	2
3E22YV8GG1782RCZH9UXZFCN0THPNV	Sunday's parliamentary vote suggested Russians are tiring of Putin and his United Russia party, which has strongly overshadowed all other political forces in Russia for the past dozen years and earned a reputation for corruption.	9	22	parliamentary	8	1	9
3E22YV8GG1782RCZH9UXZFCN0THPNV	Sunday's parliamentary vote suggested Russians are tiring of Putin and his United Russia party, which has strongly overshadowed all other political forces in Russia for the past dozen years and earned a reputation for corruption.	28	37	suggested	0	1	1
3E22YV8GG1782RCZH9UXZFCN0THPNV	Sunday's parliamentary vote suggested Russians are tiring of Putin and his United Russia party, which has strongly overshadowed all other political forces in Russia for the past dozen years and earned a reputation for corruption.	51	57	tiring	0	1	1
3E22YV8GG1782RCZH9UXZFCN0THPNV	Sunday's parliamentary vote suggested Russians are tiring of Putin and his United Russia party, which has strongly overshadowed all other political forces in Russia for the past dozen years and earned a reputation for corruption.	51	60	tiring of	1	1	2
3E22YV8GG1782RCZH9UXZFCN0THPNV	Sunday's parliamentary vote suggested Russians are tiring of Putin and his United Russia party, which has strongly overshadowed all other political forces in Russia for the past dozen years and earned a reputation for corruption.	106	127	strongly overshadowed	1	0	1
3E22YV8GG1782RCZH9UXZFCN0THPNV	Sunday's parliamentary vote suggested Russians are tiring of Putin and his United Russia party, which has strongly overshadowed all other political forces in Russia for the past dozen years and earned a reputation for corruption.	115	127	overshadowed	10	10	20
3E22YV8GG1782RCZH9UXZFCN0THPNV	Sunday's parliamentary vote suggested Russians are tiring of Putin and his United Russia party, which has strongly overshadowed all other political forces in Russia for the past dozen years and earned a reputation for corruption.	203	213	reputation	6	4	10
3E22YV8GG1782RCZH9UXZFCN0THPNV	Sunday's parliamentary vote suggested Russians are tiring of Putin and his United Russia party, which has strongly overshadowed all other political forces in Russia for the past dozen years and earned a reputation for corruption.	203	228	reputation for corruption	1	0	1
3E22YV8GG1782RCZH9UXZFCN0THPNV	Sunday's parliamentary vote suggested Russians are tiring of Putin and his United Russia party, which has strongly overshadowed all other political forces in Russia for the past dozen years and earned a reputation for corruption.	218	228	corruption	8	8	16
3E22YV8GG1782RCZH9UXZFCN0THPNV	Preliminary results indicate the party won less than 50 per cent of votes, a steep fall from its earlier majority.	0	11	Preliminary	5	2	7
3E22YV8GG1782RCZH9UXZFCN0THPNV	Preliminary results indicate the party won less than 50 per cent of votes, a steep fall from its earlier majority.	0	19	Preliminary results	0	1	1
3E22YV8GG1782RCZH9UXZFCN0THPNV	Preliminary results indicate the party won less than 50 per cent of votes, a steep fall from its earlier majority.	12	28	results indicate	0	1	1
3E22YV8GG1782RCZH9UXZFCN0THPNV	Preliminary results indicate the party won less than 50 per cent of votes, a steep fall from its earlier majority.	20	28	indicate	0	1	1
3E22YV8GG1782RCZH9UXZFCN0THPNV	Preliminary results indicate the party won less than 50 per cent of votes, a steep fall from its earlier majority.	77	82	steep	0	2	2
3E22YV8GG1782RCZH9UXZFCN0THPNV	Preliminary results indicate the party won less than 50 per cent of votes, a steep fall from its earlier majority.	77	87	steep fall	1	1	2
3E22YV8GG1782RCZH9UXZFCN0THPNV	Preliminary results indicate the party won less than 50 per cent of votes, a steep fall from its earlier majority.	105	113	majority	1	0	1
37PGLWGSJT7FDZ4S71CXYQU7J7EIKD	The immediate market reaction to Friday's government announcements was negative.	4	13	immediate	5	2	7
37PGLWGSJT7FDZ4S71CXYQU7J7EIKD	The immediate market reaction to Friday's government announcements was negative.	4	29	immediate market reaction	2	1	3
37PGLWGSJT7FDZ4S71CXYQU7J7EIKD	The immediate market reaction to Friday's government announcements was negative.	14	29	market reaction	3	1	4
37PGLWGSJT7FDZ4S71CXYQU7J7EIKD	The immediate market reaction to Friday's government announcements was negative.	42	66	government announcements	1	0	1
37PGLWGSJT7FDZ4S71CXYQU7J7EIKD	The immediate market reaction to Friday's government announcements was negative.	53	66	announcements	0	1	1
37PGLWGSJT7FDZ4S71CXYQU7J7EIKD	The immediate market reaction to Friday's government announcements was negative.	71	79	negative	1	0	1
37PGLWGSJT7FDZ4S71CXYQU7J7EIKD	But later the gap between yields on Spanish and German benchmark government bonds - a measure of how risky investors judge lending to Spain to be - narrowed somewhat to 450 basis points and Spanish bluechip shares moderated their fall to 0.76 percent.	26	32	yields	8	4	12
37PGLWGSJT7FDZ4S71CXYQU7J7EIKD	But later the gap between yields on Spanish and German benchmark government bonds - a measure of how risky investors judge lending to Spain to be - narrowed somewhat to 450 basis points and Spanish bluechip shares moderated their fall to 0.76 percent.	55	64	benchmark	4	3	7
37PGLWGSJT7FDZ4S71CXYQU7J7EIKD	But later the gap between yields on Spanish and German benchmark government bonds - a measure of how risky investors judge lending to Spain to be - narrowed somewhat to 450 basis points and Spanish bluechip shares moderated their fall to 0.76 percent.	55	81	benchmark government bonds	6	1	7
37PGLWGSJT7FDZ4S71CXYQU7J7EIKD	But later the gap between yields on Spanish and German benchmark government bonds - a measure of how risky investors judge lending to Spain to be - narrowed somewhat to 450 basis points and Spanish bluechip shares moderated their fall to 0.76 percent.	76	81	bonds	2	0	2
37PGLWGSJT7FDZ4S71CXYQU7J7EIKD	But later the gap between yields on Spanish and German benchmark government bonds - a measure of how risky investors judge lending to Spain to be - narrowed somewhat to 450 basis points and Spanish bluechip shares moderated their fall to 0.76 percent.	86	93	measure	0	1	1
37PGLWGSJT7FDZ4S71CXYQU7J7EIKD	But later the gap between yields on Spanish and German benchmark government bonds - a measure of how risky investors judge lending to Spain to be - narrowed somewhat to 450 basis points and Spanish bluechip shares moderated their fall to 0.76 percent.	101	106	risky	0	3	3
37PGLWGSJT7FDZ4S71CXYQU7J7EIKD	But later the gap between yields on Spanish and German benchmark government bonds - a measure of how risky investors judge lending to Spain to be - narrowed somewhat to 450 basis points and Spanish bluechip shares moderated their fall to 0.76 percent.	101	116	risky investors	1	1	2
37PGLWGSJT7FDZ4S71CXYQU7J7EIKD	But later the gap between yields on Spanish and German benchmark government bonds - a measure of how risky investors judge lending to Spain to be - narrowed somewhat to 450 basis points and Spanish bluechip shares moderated their fall to 0.76 percent.	107	116	investors	2	2	4
37PGLWGSJT7FDZ4S71CXYQU7J7EIKD	But later the gap between yields on Spanish and German benchmark government bonds - a measure of how risky investors judge lending to Spain to be - narrowed somewhat to 450 basis points and Spanish bluechip shares moderated their fall to 0.76 percent.	123	130	lending	0	4	4
37PGLWGSJT7FDZ4S71CXYQU7J7EIKD	But later the gap between yields on Spanish and German benchmark government bonds - a measure of how risky investors judge lending to Spain to be - narrowed somewhat to 450 basis points and Spanish bluechip shares moderated their fall to 0.76 percent.	148	156	narrowed	2	6	8
37PGLWGSJT7FDZ4S71CXYQU7J7EIKD	But later the gap between yields on Spanish and German benchmark government bonds - a measure of how risky investors judge lending to Spain to be - narrowed somewhat to 450 basis points and Spanish bluechip shares moderated their fall to 0.76 percent.	173	185	basis points	4	0	4
37PGLWGSJT7FDZ4S71CXYQU7J7EIKD	But later the gap between yields on Spanish and German benchmark government bonds - a measure of how risky investors judge lending to Spain to be - narrowed somewhat to 450 basis points and Spanish bluechip shares moderated their fall to 0.76 percent.	198	206	bluechip	5	5	10
37PGLWGSJT7FDZ4S71CXYQU7J7EIKD	But later the gap between yields on Spanish and German benchmark government bonds - a measure of how risky investors judge lending to Spain to be - narrowed somewhat to 450 basis points and Spanish bluechip shares moderated their fall to 0.76 percent.	198	213	bluechip shares	8	1	9
37PGLWGSJT7FDZ4S71CXYQU7J7EIKD	But later the gap between yields on Spanish and German benchmark government bonds - a measure of how risky investors judge lending to Spain to be - narrowed somewhat to 450 basis points and Spanish bluechip shares moderated their fall to 0.76 percent.	198	223	bluechip shares moderated	1	0	1
37PGLWGSJT7FDZ4S71CXYQU7J7EIKD	But later the gap between yields on Spanish and German benchmark government bonds - a measure of how risky investors judge lending to Spain to be - narrowed somewhat to 450 basis points and Spanish bluechip shares moderated their fall to 0.76 percent.	207	213	shares	1	0	1
37PGLWGSJT7FDZ4S71CXYQU7J7EIKD	But later the gap between yields on Spanish and German benchmark government bonds - a measure of how risky investors judge lending to Spain to be - narrowed somewhat to 450 basis points and Spanish bluechip shares moderated their fall to 0.76 percent.	214	223	moderated	3	6	9
37PGLWGSJT7FDZ4S71CXYQU7J7EIKD	Banks have until the end of the year to move their holdings of repossessed property into asset management firms for a fire sale, Economy Minister Luis de Guindos told a news conference.	51	59	holdings	1	0	1
37PGLWGSJT7FDZ4S71CXYQU7J7EIKD	Banks have until the end of the year to move their holdings of repossessed property into asset management firms for a fire sale, Economy Minister Luis de Guindos told a news conference.	51	83	holdings of repossessed property	1	0	1
37PGLWGSJT7FDZ4S71CXYQU7J7EIKD	Banks have until the end of the year to move their holdings of repossessed property into asset management firms for a fire sale, Economy Minister Luis de Guindos told a news conference.	63	74	repossessed	9	7	16
37PGLWGSJT7FDZ4S71CXYQU7J7EIKD	Banks have until the end of the year to move their holdings of repossessed property into asset management firms for a fire sale, Economy Minister Luis de Guindos told a news conference.	63	83	repossessed property	4	2	6
37PGLWGSJT7FDZ4S71CXYQU7J7EIKD	Banks have until the end of the year to move their holdings of repossessed property into asset management firms for a fire sale, Economy Minister Luis de Guindos told a news conference.	89	94	asset	1	0	1
37PGLWGSJT7FDZ4S71CXYQU7J7EIKD	Banks have until the end of the year to move their holdings of repossessed property into asset management firms for a fire sale, Economy Minister Luis de Guindos told a news conference.	89	105	asset management	1	1	2
37PGLWGSJT7FDZ4S71CXYQU7J7EIKD	Banks have until the end of the year to move their holdings of repossessed property into asset management firms for a fire sale, Economy Minister Luis de Guindos told a news conference.	89	111	asset management firms	6	0	6
37PGLWGSJT7FDZ4S71CXYQU7J7EIKD	Banks have until the end of the year to move their holdings of repossessed property into asset management firms for a fire sale, Economy Minister Luis de Guindos told a news conference.	118	127	fire sale	4	1	5
37PGLWGSJT7FDZ4S71CXYQU7J7EIKD	Banks have until the end of the year to move their holdings of repossessed property into asset management firms for a fire sale, Economy Minister Luis de Guindos told a news conference.	146	161	Luis de Guindos	1	0	1
37PGLWGSJT7FDZ4S71CXYQU7J7EIKD	Banks have until the end of the year to move their holdings of repossessed property into asset management firms for a fire sale, Economy Minister Luis de Guindos told a news conference.	174	184	conference	2	0	2
37PGLWGSJT7FDZ4S71CXYQU7J7EIKD	The state will put less than 15 billion euros into the latest of the four separate bank rescues that Spain has enacted over the past three years, de Guindos estimated.	74	82	separate	0	1	1
37PGLWGSJT7FDZ4S71CXYQU7J7EIKD	The state will put less than 15 billion euros into the latest of the four separate bank rescues that Spain has enacted over the past three years, de Guindos estimated.	83	95	bank rescues	2	0	2
37PGLWGSJT7FDZ4S71CXYQU7J7EIKD	The state will put less than 15 billion euros into the latest of the four separate bank rescues that Spain has enacted over the past three years, de Guindos estimated.	88	95	rescues	3	5	8
37PGLWGSJT7FDZ4S71CXYQU7J7EIKD	The state will put less than 15 billion euros into the latest of the four separate bank rescues that Spain has enacted over the past three years, de Guindos estimated.	111	118	enacted	7	10	17
37PGLWGSJT7FDZ4S71CXYQU7J7EIKD	The state will put less than 15 billion euros into the latest of the four separate bank rescues that Spain has enacted over the past three years, de Guindos estimated.	146	156	de Guindos	1	0	1
37PGLWGSJT7FDZ4S71CXYQU7J7EIKD	The state will put less than 15 billion euros into the latest of the four separate bank rescues that Spain has enacted over the past three years, de Guindos estimated.	157	166	estimated	3	2	5
30OITAWPBQ4V08AHXM3N85FC9DQ9HB	The teenage girl shot dead in Bellaghy, County Londonderry, on Saturday morning was 18-year-old Lauren O'Neill.	4	11	teenage	0	1	1
30OITAWPBQ4V08AHXM3N85FC9DQ9HB	The teenage girl shot dead in Bellaghy, County Londonderry, on Saturday morning was 18-year-old Lauren O'Neill.	4	16	teenage girl	0	1	1
30OITAWPBQ4V08AHXM3N85FC9DQ9HB	The teenage girl shot dead in Bellaghy, County Londonderry, on Saturday morning was 18-year-old Lauren O'Neill.	47	58	Londonderry	1	0	1
30OITAWPBQ4V08AHXM3N85FC9DQ9HB	Her 21-year-old sister Brenda remains in a critical condition in the Royal Victoria Hospital in Belfast.	43	51	critical	2	4	6
30OITAWPBQ4V08AHXM3N85FC9DQ9HB	Her 21-year-old sister Brenda remains in a critical condition in the Royal Victoria Hospital in Belfast.	43	61	critical condition	9	3	12
30OITAWPBQ4V08AHXM3N85FC9DQ9HB	Bellaghy parish priest Fr Andy Dolan said the teenager died trying to protect her sister.	0	15	Bellaghy parish	0	1	1
30OITAWPBQ4V08AHXM3N85FC9DQ9HB	Bellaghy parish priest Fr Andy Dolan said the teenager died trying to protect her sister.	9	15	parish	4	2	6
30OITAWPBQ4V08AHXM3N85FC9DQ9HB	Bellaghy parish priest Fr Andy Dolan said the teenager died trying to protect her sister.	9	22	parish priest	1	1	2
30OITAWPBQ4V08AHXM3N85FC9DQ9HB	Bellaghy parish priest Fr Andy Dolan said the teenager died trying to protect her sister.	70	77	protect	0	1	1
30OITAWPBQ4V08AHXM3N85FC9DQ9HB	The police are continuing to question a 26-year-old man in connection with the incident.	15	25	continuing	2	1	3
30OITAWPBQ4V08AHXM3N85FC9DQ9HB	The police are continuing to question a 26-year-old man in connection with the incident.	56	74	in connection with	1	0	1
30OITAWPBQ4V08AHXM3N85FC9DQ9HB	The police are continuing to question a 26-year-old man in connection with the incident.	56	87	in connection with the incident	1	0	1
30OITAWPBQ4V08AHXM3N85FC9DQ9HB	The police are continuing to question a 26-year-old man in connection with the incident.	59	69	connection	3	3	6
30OITAWPBQ4V08AHXM3N85FC9DQ9HB	The police are continuing to question a 26-year-old man in connection with the incident.	79	87	incident	7	7	14
30OITAWPBQ4V08AHXM3N85FC9DQ9HB	Fr Dolan told BBC Radio Ulster: "When Brenda was under attack, Lauren dived in to save her and in the process lost her own life.	49	61	under attack	0	1	1
30OITAWPBQ4V08AHXM3N85FC9DQ9HB	Fr Dolan told BBC Radio Ulster: "When Brenda was under attack, Lauren dived in to save her and in the process lost her own life.	70	75	dived	3	3	6
30OITAWPBQ4V08AHXM3N85FC9DQ9HB	Fr Dolan told BBC Radio Ulster: "When Brenda was under attack, Lauren dived in to save her and in the process lost her own life.	102	109	process	2	2	4
30OITAWPBQ4V08AHXM3N85FC9DQ9HB	A man and a woman questioned on suspicion of assisting an offender have been released.	18	28	questioned	1	0	1
30OITAWPBQ4V08AHXM3N85FC9DQ9HB	A man and a woman questioned on suspicion of assisting an offender have been released.	18	54	questioned on suspicion of assisting	0	1	1
30OITAWPBQ4V08AHXM3N85FC9DQ9HB	A man and a woman questioned on suspicion of assisting an offender have been released.	32	41	suspicion	10	10	20
30OITAWPBQ4V08AHXM3N85FC9DQ9HB	A man and a woman questioned on suspicion of assisting an offender have been released.	32	66	suspicion of assisting an offender	4	0	4
30OITAWPBQ4V08AHXM3N85FC9DQ9HB	A man and a woman questioned on suspicion of assisting an offender have been released.	45	54	assisting	4	4	8
30OITAWPBQ4V08AHXM3N85FC9DQ9HB	A man and a woman questioned on suspicion of assisting an offender have been released.	45	66	assisting an offender	1	1	2
30OITAWPBQ4V08AHXM3N85FC9DQ9HB	A man and a woman questioned on suspicion of assisting an offender have been released.	58	66	offender	2	10	12
30OITAWPBQ4V08AHXM3N85FC9DQ9HB	A man and a woman questioned on suspicion of assisting an offender have been released.	72	85	been released	1	0	1
30OITAWPBQ4V08AHXM3N85FC9DQ9HB	A man and a woman questioned on suspicion of assisting an offender have been released.	77	85	released	1	3	4
3PR3LXCWSF0SMYAW2QL9BR36X399X4	Speaking via Skype from Hama, activist Mousab Alhamadee said one local rebel leader was killed alongside five civilians.	13	18	Skype	2	0	2
3PR3LXCWSF0SMYAW2QL9BR36X399X4	Speaking via Skype from Hama, activist Mousab Alhamadee said one local rebel leader was killed alongside five civilians.	30	38	activist	2	6	8
3PR3LXCWSF0SMYAW2QL9BR36X399X4	Speaking via Skype from Hama, activist Mousab Alhamadee said one local rebel leader was killed alongside five civilians.	39	55	Mousab Alhamadee	0	2	2
3PR3LXCWSF0SMYAW2QL9BR36X399X4	Speaking via Skype from Hama, activist Mousab Alhamadee said one local rebel leader was killed alongside five civilians.	65	83	local rebel leader	0	1	1
3PR3LXCWSF0SMYAW2QL9BR36X399X4	Speaking via Skype from Hama, activist Mousab Alhamadee said one local rebel leader was killed alongside five civilians.	71	76	rebel	0	3	3
3PR3LXCWSF0SMYAW2QL9BR36X399X4	Speaking via Skype from Hama, activist Mousab Alhamadee said one local rebel leader was killed alongside five civilians.	95	104	alongside	3	5	8
3PR3LXCWSF0SMYAW2QL9BR36X399X4	Speaking via Skype from Hama, activist Mousab Alhamadee said one local rebel leader was killed alongside five civilians.	110	119	civilians	5	2	7
3PR3LXCWSF0SMYAW2QL9BR36X399X4	"He was a hero in the Free Syrian Army who was trying to defend the civilians," he said, referring to the umbrella group of local, anti-regime militias.	57	63	defend	1	2	3
3PR3LXCWSF0SMYAW2QL9BR36X399X4	"He was a hero in the Free Syrian Army who was trying to defend the civilians," he said, referring to the umbrella group of local, anti-regime militias.	68	77	civilians	0	1	1
3PR3LXCWSF0SMYAW2QL9BR36X399X4	"He was a hero in the Free Syrian Army who was trying to defend the civilians," he said, referring to the umbrella group of local, anti-regime militias.	89	98	referring	2	3	5
3PR3LXCWSF0SMYAW2QL9BR36X399X4	"He was a hero in the Free Syrian Army who was trying to defend the civilians," he said, referring to the umbrella group of local, anti-regime militias.	106	114	umbrella	1	0	1
3PR3LXCWSF0SMYAW2QL9BR36X399X4	"He was a hero in the Free Syrian Army who was trying to defend the civilians," he said, referring to the umbrella group of local, anti-regime militias.	106	120	umbrella group	7	3	10
3PR3LXCWSF0SMYAW2QL9BR36X399X4	"He was a hero in the Free Syrian Army who was trying to defend the civilians," he said, referring to the umbrella group of local, anti-regime militias.	131	142	anti-regime	5	3	8
3PR3LXCWSF0SMYAW2QL9BR36X399X4	"He was a hero in the Free Syrian Army who was trying to defend the civilians," he said, referring to the umbrella group of local, anti-regime militias.	131	151	anti-regime militias	6	5	11
3PR3LXCWSF0SMYAW2QL9BR36X399X4	"He was a hero in the Free Syrian Army who was trying to defend the civilians," he said, referring to the umbrella group of local, anti-regime militias.	143	151	militias	7	5	12
3PR3LXCWSF0SMYAW2QL9BR36X399X4	An amateur video posted online Sunday showed men carrying the dead body of a woman from a house.	3	10	amateur	8	8	16
3PR3LXCWSF0SMYAW2QL9BR36X399X4	An amateur video posted online Sunday showed men carrying the dead body of a woman from a house.	3	16	amateur video	1	2	3
3PR3LXCWSF0SMYAW2QL9BR36X399X4	A second video showed men in a mosque praying over five coffins, three of them open with flowers piled on bodies wrapped in white cloth.	31	37	mosque	5	1	6
3PR3LXCWSF0SMYAW2QL9BR36X399X4	A second video showed men in a mosque praying over five coffins, three of them open with flowers piled on bodies wrapped in white cloth.	56	63	coffins	1	4	5
3PR3LXCWSF0SMYAW2QL9BR36X399X4	A second video showed men in a mosque praying over five coffins, three of them open with flowers piled on bodies wrapped in white cloth.	97	102	piled	0	4	4
3PR3LXCWSF0SMYAW2QL9BR36X399X4	A second video showed men in a mosque praying over five coffins, three of them open with flowers piled on bodies wrapped in white cloth.	113	120	wrapped	2	4	6
3PR3LXCWSF0SMYAW2QL9BR36X399X4	A second video showed men in a mosque praying over five coffins, three of them open with flowers piled on bodies wrapped in white cloth.	130	135	cloth	0	1	1
3PR3LXCWSF0SMYAW2QL9BR36X399X4	The area, a plain of farmland along the Orontes River, is dotted with villages of Christians, Sunni Muslims and Alawites, the offshoot sect of Shiite Islam to which Assad belongs.	12	29	plain of farmland	1	0	1
3PR3LXCWSF0SMYAW2QL9BR36X399X4	The area, a plain of farmland along the Orontes River, is dotted with villages of Christians, Sunni Muslims and Alawites, the offshoot sect of Shiite Islam to which Assad belongs.	21	29	farmland	0	2	2
3PR3LXCWSF0SMYAW2QL9BR36X399X4	The area, a plain of farmland along the Orontes River, is dotted with villages of Christians, Sunni Muslims and Alawites, the offshoot sect of Shiite Islam to which Assad belongs.	58	64	dotted	3	3	6
3PR3LXCWSF0SMYAW2QL9BR36X399X4	The area, a plain of farmland along the Orontes River, is dotted with villages of Christians, Sunni Muslims and Alawites, the offshoot sect of Shiite Islam to which Assad belongs.	112	120	Alawites	0	1	1
3PR3LXCWSF0SMYAW2QL9BR36X399X4	The area, a plain of farmland along the Orontes River, is dotted with villages of Christians, Sunni Muslims and Alawites, the offshoot sect of Shiite Islam to which Assad belongs.	126	134	offshoot	2	6	8
3PR3LXCWSF0SMYAW2QL9BR36X399X4	The area, a plain of farmland along the Orontes River, is dotted with villages of Christians, Sunni Muslims and Alawites, the offshoot sect of Shiite Islam to which Assad belongs.	126	139	offshoot sect	6	4	10
3PR3LXCWSF0SMYAW2QL9BR36X399X4	The area, a plain of farmland along the Orontes River, is dotted with villages of Christians, Sunni Muslims and Alawites, the offshoot sect of Shiite Islam to which Assad belongs.	135	139	sect	1	1	2
3PR3LXCWSF0SMYAW2QL9BR36X399X4	The area, a plain of farmland along the Orontes River, is dotted with villages of Christians, Sunni Muslims and Alawites, the offshoot sect of Shiite Islam to which Assad belongs.	143	149	Shiite	0	2	2
3PR3LXCWSF0SMYAW2QL9BR36X399X4	Alhamadee, who is from a village near al-Tamana, said sectarian tensions were low before the uprising, but have deteriorated as Sunni villages like al-Tamana joined the anti-Assad uprising.	0	9	Alhamadee	0	1	1
3PR3LXCWSF0SMYAW2QL9BR36X399X4	Alhamadee, who is from a village near al-Tamana, said sectarian tensions were low before the uprising, but have deteriorated as Sunni villages like al-Tamana joined the anti-Assad uprising.	54	63	sectarian	4	4	8
3PR3LXCWSF0SMYAW2QL9BR36X399X4	Alhamadee, who is from a village near al-Tamana, said sectarian tensions were low before the uprising, but have deteriorated as Sunni villages like al-Tamana joined the anti-Assad uprising.	54	72	sectarian tensions	7	3	10
3PR3LXCWSF0SMYAW2QL9BR36X399X4	Alhamadee, who is from a village near al-Tamana, said sectarian tensions were low before the uprising, but have deteriorated as Sunni villages like al-Tamana joined the anti-Assad uprising.	93	101	uprising	1	6	7
3PR3LXCWSF0SMYAW2QL9BR36X399X4	Alhamadee, who is from a village near al-Tamana, said sectarian tensions were low before the uprising, but have deteriorated as Sunni villages like al-Tamana joined the anti-Assad uprising.	112	124	deteriorated	10	9	19
3PR3LXCWSF0SMYAW2QL9BR36X399X4	Alhamadee, who is from a village near al-Tamana, said sectarian tensions were low before the uprising, but have deteriorated as Sunni villages like al-Tamana joined the anti-Assad uprising.	169	179	anti-Assad	1	0	1
3PR3LXCWSF0SMYAW2QL9BR36X399X4	Alhamadee, who is from a village near al-Tamana, said sectarian tensions were low before the uprising, but have deteriorated as Sunni villages like al-Tamana joined the anti-Assad uprising.	180	188	uprising	3	1	4
3OND0WXMHWGCV41Y5XJ90JGN0A6HET	New updates, better-optimized versions of Android may go directly to Motorola, while taking much longer to reach other smartphone manufactures.	0	11	New updates	0	1	1
3OND0WXMHWGCV41Y5XJ90JGN0A6HET	New updates, better-optimized versions of Android may go directly to Motorola, while taking much longer to reach other smartphone manufactures.	4	11	updates	1	2	3
3OND0WXMHWGCV41Y5XJ90JGN0A6HET	New updates, better-optimized versions of Android may go directly to Motorola, while taking much longer to reach other smartphone manufactures.	13	29	better-optimized	9	5	14
3OND0WXMHWGCV41Y5XJ90JGN0A6HET	New updates, better-optimized versions of Android may go directly to Motorola, while taking much longer to reach other smartphone manufactures.	13	38	better-optimized versions	5	2	7
3OND0WXMHWGCV41Y5XJ90JGN0A6HET	New updates, better-optimized versions of Android may go directly to Motorola, while taking much longer to reach other smartphone manufactures.	30	38	versions	0	1	1
3OND0WXMHWGCV41Y5XJ90JGN0A6HET	New updates, better-optimized versions of Android may go directly to Motorola, while taking much longer to reach other smartphone manufactures.	42	49	Android	1	0	1
3OND0WXMHWGCV41Y5XJ90JGN0A6HET	New updates, better-optimized versions of Android may go directly to Motorola, while taking much longer to reach other smartphone manufactures.	119	129	smartphone	1	0	1
3OND0WXMHWGCV41Y5XJ90JGN0A6HET	New updates, better-optimized versions of Android may go directly to Motorola, while taking much longer to reach other smartphone manufactures.	119	142	smartphone manufactures	3	0	3
3OND0WXMHWGCV41Y5XJ90JGN0A6HET	New updates, better-optimized versions of Android may go directly to Motorola, while taking much longer to reach other smartphone manufactures.	130	142	manufactures	2	0	2
3OND0WXMHWGCV41Y5XJ90JGN0A6HET	Google defended itself saying it has no intentions of giving Motorola special treatment over other Android-running OEMs such as HTC, Samsung, and LG.	7	15	defended	1	3	4
3OND0WXMHWGCV41Y5XJ90JGN0A6HET	Google defended itself saying it has no intentions of giving Motorola special treatment over other Android-running OEMs such as HTC, Samsung, and LG.	40	50	intentions	5	5	10
3OND0WXMHWGCV41Y5XJ90JGN0A6HET	Google defended itself saying it has no intentions of giving Motorola special treatment over other Android-running OEMs such as HTC, Samsung, and LG.	70	87	special treatment	2	0	2
3OND0WXMHWGCV41Y5XJ90JGN0A6HET	Google defended itself saying it has no intentions of giving Motorola special treatment over other Android-running OEMs such as HTC, Samsung, and LG.	99	114	Android-running	0	1	1
3OND0WXMHWGCV41Y5XJ90JGN0A6HET	Google defended itself saying it has no intentions of giving Motorola special treatment over other Android-running OEMs such as HTC, Samsung, and LG.	99	119	Android-running OEMs	0	1	1
3OND0WXMHWGCV41Y5XJ90JGN0A6HET	Google defended itself saying it has no intentions of giving Motorola special treatment over other Android-running OEMs such as HTC, Samsung, and LG.	115	119	OEMs	2	2	4
3OND0WXMHWGCV41Y5XJ90JGN0A6HET	Apparently the argument was enough for Google it get over all of the regulatory hurdles it needed to close the deal.	0	10	Apparently	2	4	6
3OND0WXMHWGCV41Y5XJ90JGN0A6HET	Apparently the argument was enough for Google it get over all of the regulatory hurdles it needed to close the deal.	15	23	argument	1	3	4
3OND0WXMHWGCV41Y5XJ90JGN0A6HET	Apparently the argument was enough for Google it get over all of the regulatory hurdles it needed to close the deal.	69	79	regulatory	2	2	4
3OND0WXMHWGCV41Y5XJ90JGN0A6HET	Apparently the argument was enough for Google it get over all of the regulatory hurdles it needed to close the deal.	69	87	regulatory hurdles	8	3	11
3OND0WXMHWGCV41Y5XJ90JGN0A6HET	Apparently the argument was enough for Google it get over all of the regulatory hurdles it needed to close the deal.	80	87	hurdles	3	6	9
3OND0WXMHWGCV41Y5XJ90JGN0A6HET	Apparently the argument was enough for Google it get over all of the regulatory hurdles it needed to close the deal.	101	115	close the deal	1	0	1
3OND0WXMHWGCV41Y5XJ90JGN0A6HET	Google is interested in purchasing Motorola mostly for its patents.	24	34	purchasing	0	1	1
3OND0WXMHWGCV41Y5XJ90JGN0A6HET	Google is interested in purchasing Motorola mostly for its patents.	59	66	patents	7	5	12
3OND0WXMHWGCV41Y5XJ90JGN0A6HET	Now that Google is duking it out in court with Oracle over Java-related patents, it's more important than ever for Google so it can defend itself against future Android lawsuits, VB says.	19	25	duking	6	8	14
3OND0WXMHWGCV41Y5XJ90JGN0A6HET	Now that Google is duking it out in court with Oracle over Java-related patents, it's more important than ever for Google so it can defend itself against future Android lawsuits, VB says.	19	32	duking it out	4	3	7
3OND0WXMHWGCV41Y5XJ90JGN0A6HET	Now that Google is duking it out in court with Oracle over Java-related patents, it's more important than ever for Google so it can defend itself against future Android lawsuits, VB says.	59	71	Java-related	3	1	4
3OND0WXMHWGCV41Y5XJ90JGN0A6HET	Now that Google is duking it out in court with Oracle over Java-related patents, it's more important than ever for Google so it can defend itself against future Android lawsuits, VB says.	59	79	Java-related patents	2	0	2
3OND0WXMHWGCV41Y5XJ90JGN0A6HET	Now that Google is duking it out in court with Oracle over Java-related patents, it's more important than ever for Google so it can defend itself against future Android lawsuits, VB says.	72	79	patents	2	0	2
3OND0WXMHWGCV41Y5XJ90JGN0A6HET	Now that Google is duking it out in court with Oracle over Java-related patents, it's more important than ever for Google so it can defend itself against future Android lawsuits, VB says.	132	138	defend	0	1	1
3OND0WXMHWGCV41Y5XJ90JGN0A6HET	Now that Google is duking it out in court with Oracle over Java-related patents, it's more important than ever for Google so it can defend itself against future Android lawsuits, VB says.	169	177	lawsuits	3	7	10
3OND0WXMHWGCV41Y5XJ90JGN0A6HET	Now that Google is duking it out in court with Oracle over Java-related patents, it's more important than ever for Google so it can defend itself against future Android lawsuits, VB says.	179	181	VB	1	0	1
3OND0WXMHWGCV41Y5XJ90JGN0A6HET	At least 300 people were detained by police at a protest in downtown Moscow on Tuesday night that included flare-type fireworks thrown at a group of pro-Kremlin youth.	25	33	detained	8	8	16
3OND0WXMHWGCV41Y5XJ90JGN0A6HET	At least 300 people were detained by police at a protest in downtown Moscow on Tuesday night that included flare-type fireworks thrown at a group of pro-Kremlin youth.	49	56	protest	0	1	1
3OND0WXMHWGCV41Y5XJ90JGN0A6HET	At least 300 people were detained by police at a protest in downtown Moscow on Tuesday night that included flare-type fireworks thrown at a group of pro-Kremlin youth.	60	68	downtown	0	2	2
3OND0WXMHWGCV41Y5XJ90JGN0A6HET	At least 300 people were detained by police at a protest in downtown Moscow on Tuesday night that included flare-type fireworks thrown at a group of pro-Kremlin youth.	98	106	included	0	1	1
3OND0WXMHWGCV41Y5XJ90JGN0A6HET	At least 300 people were detained by police at a protest in downtown Moscow on Tuesday night that included flare-type fireworks thrown at a group of pro-Kremlin youth.	107	117	flare-type	6	8	14
3OND0WXMHWGCV41Y5XJ90JGN0A6HET	At least 300 people were detained by police at a protest in downtown Moscow on Tuesday night that included flare-type fireworks thrown at a group of pro-Kremlin youth.	107	127	flare-type fireworks	3	3	6
3OND0WXMHWGCV41Y5XJ90JGN0A6HET	At least 300 people were detained by police at a protest in downtown Moscow on Tuesday night that included flare-type fireworks thrown at a group of pro-Kremlin youth.	118	127	fireworks	0	1	1
3OND0WXMHWGCV41Y5XJ90JGN0A6HET	At least 300 people were detained by police at a protest in downtown Moscow on Tuesday night that included flare-type fireworks thrown at a group of pro-Kremlin youth.	149	160	pro-Kremlin	3	1	4
3OND0WXMHWGCV41Y5XJ90JGN0A6HET	At least 300 people were detained by police at a protest in downtown Moscow on Tuesday night that included flare-type fireworks thrown at a group of pro-Kremlin youth.	149	166	pro-Kremlin youth	0	1	1
3SV8KD29L4T18PT2750JYLXXFKGKZC	Spain's banks were hit by billions of euros of losses after the bursting of a decade-long property bubble in 2008 and concerns about them, and the country's overspending regional governments, have fanned fears of a new euro zone debt crisis.	19	22	hit	1	0	1
3SV8KD29L4T18PT2750JYLXXFKGKZC	Spain's banks were hit by billions of euros of losses after the bursting of a decade-long property bubble in 2008 and concerns about them, and the country's overspending regional governments, have fanned fears of a new euro zone debt crisis.	38	43	euros	1	0	1
3SV8KD29L4T18PT2750JYLXXFKGKZC	Spain's banks were hit by billions of euros of losses after the bursting of a decade-long property bubble in 2008 and concerns about them, and the country's overspending regional governments, have fanned fears of a new euro zone debt crisis.	47	53	losses	1	0	1
3SV8KD29L4T18PT2750JYLXXFKGKZC	Spain's banks were hit by billions of euros of losses after the bursting of a decade-long property bubble in 2008 and concerns about them, and the country's overspending regional governments, have fanned fears of a new euro zone debt crisis.	64	72	bursting	5	8	13
3SV8KD29L4T18PT2750JYLXXFKGKZC	Spain's banks were hit by billions of euros of losses after the bursting of a decade-long property bubble in 2008 and concerns about them, and the country's overspending regional governments, have fanned fears of a new euro zone debt crisis.	78	89	decade-long	2	4	6
3SV8KD29L4T18PT2750JYLXXFKGKZC	Spain's banks were hit by billions of euros of losses after the bursting of a decade-long property bubble in 2008 and concerns about them, and the country's overspending regional governments, have fanned fears of a new euro zone debt crisis.	78	105	decade-long property bubble	1	1	2
3SV8KD29L4T18PT2750JYLXXFKGKZC	Spain's banks were hit by billions of euros of losses after the bursting of a decade-long property bubble in 2008 and concerns about them, and the country's overspending regional governments, have fanned fears of a new euro zone debt crisis.	90	105	property bubble	7	1	8
3SV8KD29L4T18PT2750JYLXXFKGKZC	Spain's banks were hit by billions of euros of losses after the bursting of a decade-long property bubble in 2008 and concerns about them, and the country's overspending regional governments, have fanned fears of a new euro zone debt crisis.	99	105	bubble	1	1	2
3SV8KD29L4T18PT2750JYLXXFKGKZC	Spain's banks were hit by billions of euros of losses after the bursting of a decade-long property bubble in 2008 and concerns about them, and the country's overspending regional governments, have fanned fears of a new euro zone debt crisis.	118	126	concerns	1	0	1
3SV8KD29L4T18PT2750JYLXXFKGKZC	Spain's banks were hit by billions of euros of losses after the bursting of a decade-long property bubble in 2008 and concerns about them, and the country's overspending regional governments, have fanned fears of a new euro zone debt crisis.	157	169	overspending	3	5	8
3SV8KD29L4T18PT2750JYLXXFKGKZC	Spain's banks were hit by billions of euros of losses after the bursting of a decade-long property bubble in 2008 and concerns about them, and the country's overspending regional governments, have fanned fears of a new euro zone debt crisis.	157	190	overspending regional governments	2	0	2
3SV8KD29L4T18PT2750JYLXXFKGKZC	Spain's banks were hit by billions of euros of losses after the bursting of a decade-long property bubble in 2008 and concerns about them, and the country's overspending regional governments, have fanned fears of a new euro zone debt crisis.	170	178	regional	1	0	1
3SV8KD29L4T18PT2750JYLXXFKGKZC	Spain's banks were hit by billions of euros of losses after the bursting of a decade-long property bubble in 2008 and concerns about them, and the country's overspending regional governments, have fanned fears of a new euro zone debt crisis.	197	203	fanned	5	8	13
3SV8KD29L4T18PT2750JYLXXFKGKZC	Spain's banks were hit by billions of euros of losses after the bursting of a decade-long property bubble in 2008 and concerns about them, and the country's overspending regional governments, have fanned fears of a new euro zone debt crisis.	197	209	fanned fears	0	2	2
3SV8KD29L4T18PT2750JYLXXFKGKZC	Spain's banks were hit by billions of euros of losses after the bursting of a decade-long property bubble in 2008 and concerns about them, and the country's overspending regional governments, have fanned fears of a new euro zone debt crisis.	215	240	new euro zone debt crisis	1	0	1
3SV8KD29L4T18PT2750JYLXXFKGKZC	Spain's banks were hit by billions of euros of losses after the bursting of a decade-long property bubble in 2008 and concerns about them, and the country's overspending regional governments, have fanned fears of a new euro zone debt crisis.	219	228	euro zone	2	0	2
3SV8KD29L4T18PT2750JYLXXFKGKZC	Spain's banks were hit by billions of euros of losses after the bursting of a decade-long property bubble in 2008 and concerns about them, and the country's overspending regional governments, have fanned fears of a new euro zone debt crisis.	219	240	euro zone debt crisis	1	1	2
3SV8KD29L4T18PT2750JYLXXFKGKZC	Spain's banks were hit by billions of euros of losses after the bursting of a decade-long property bubble in 2008 and concerns about them, and the country's overspending regional governments, have fanned fears of a new euro zone debt crisis.	229	240	debt crisis	4	2	6
3SV8KD29L4T18PT2750JYLXXFKGKZC	Spain's banks were hit by billions of euros of losses after the bursting of a decade-long property bubble in 2008 and concerns about them, and the country's overspending regional governments, have fanned fears of a new euro zone debt crisis.	234	240	crisis	0	1	1
3SV8KD29L4T18PT2750JYLXXFKGKZC	The toxic assets now total 184 billion euros, but many fear the hole is even bigger.	4	9	toxic	1	1	2
3SV8KD29L4T18PT2750JYLXXFKGKZC	The toxic assets now total 184 billion euros, but many fear the hole is even bigger.	4	16	toxic assets	7	4	11
3SV8KD29L4T18PT2750JYLXXFKGKZC	The toxic assets now total 184 billion euros, but many fear the hole is even bigger.	10	16	assets	1	1	2
3SV8KD29L4T18PT2750JYLXXFKGKZC	The toxic assets now total 184 billion euros, but many fear the hole is even bigger.	60	83	the hole is even bigger	1	0	1
3SV8KD29L4T18PT2750JYLXXFKGKZC	Successive waves of bank sector clean-ups have failed to convince investors.	0	10	Successive	7	3	10
3SV8KD29L4T18PT2750JYLXXFKGKZC	Successive waves of bank sector clean-ups have failed to convince investors.	0	16	Successive waves	4	2	6
3SV8KD29L4T18PT2750JYLXXFKGKZC	Successive waves of bank sector clean-ups have failed to convince investors.	0	41	Successive waves of bank sector clean-ups	0	1	1
3SV8KD29L4T18PT2750JYLXXFKGKZC	Successive waves of bank sector clean-ups have failed to convince investors.	11	16	waves	0	1	1
3SV8KD29L4T18PT2750JYLXXFKGKZC	Successive waves of bank sector clean-ups have failed to convince investors.	20	31	bank sector	1	0	1
3SV8KD29L4T18PT2750JYLXXFKGKZC	Successive waves of bank sector clean-ups have failed to convince investors.	25	31	sector	1	0	1
3SV8KD29L4T18PT2750JYLXXFKGKZC	Successive waves of bank sector clean-ups have failed to convince investors.	32	41	clean-ups	4	2	6
3SV8KD29L4T18PT2750JYLXXFKGKZC	Successive waves of bank sector clean-ups have failed to convince investors.	57	65	convince	1	2	3
3SV8KD29L4T18PT2750JYLXXFKGKZC	Successive waves of bank sector clean-ups have failed to convince investors.	57	75	convince investors	0	1	1
3SV8KD29L4T18PT2750JYLXXFKGKZC	Successive waves of bank sector clean-ups have failed to convince investors.	66	75	investors	1	1	2
3SV8KD29L4T18PT2750JYLXXFKGKZC	A reform package for Spain's troubled banks, aimed at convincing investors that the sector is solvent and the country has a strategy to avoid a bailout, is expected to be released.	2	8	reform	2	1	3
3SV8KD29L4T18PT2750JYLXXFKGKZC	A reform package for Spain's troubled banks, aimed at convincing investors that the sector is solvent and the country has a strategy to avoid a bailout, is expected to be released.	2	16	reform package	4	2	6
3SV8KD29L4T18PT2750JYLXXFKGKZC	A reform package for Spain's troubled banks, aimed at convincing investors that the sector is solvent and the country has a strategy to avoid a bailout, is expected to be released.	29	43	troubled banks	0	1	1
3SV8KD29L4T18PT2750JYLXXFKGKZC	A reform package for Spain's troubled banks, aimed at convincing investors that the sector is solvent and the country has a strategy to avoid a bailout, is expected to be released.	54	64	convincing	2	1	3
3SV8KD29L4T18PT2750JYLXXFKGKZC	A reform package for Spain's troubled banks, aimed at convincing investors that the sector is solvent and the country has a strategy to avoid a bailout, is expected to be released.	54	74	convincing investors	1	0	1
3SV8KD29L4T18PT2750JYLXXFKGKZC	A reform package for Spain's troubled banks, aimed at convincing investors that the sector is solvent and the country has a strategy to avoid a bailout, is expected to be released.	65	74	investors	1	0	1
3SV8KD29L4T18PT2750JYLXXFKGKZC	A reform package for Spain's troubled banks, aimed at convincing investors that the sector is solvent and the country has a strategy to avoid a bailout, is expected to be released.	80	101	the sector is solvent	1	0	1
3SV8KD29L4T18PT2750JYLXXFKGKZC	A reform package for Spain's troubled banks, aimed at convincing investors that the sector is solvent and the country has a strategy to avoid a bailout, is expected to be released.	94	101	solvent	10	8	18
3SV8KD29L4T18PT2750JYLXXFKGKZC	A reform package for Spain's troubled banks, aimed at convincing investors that the sector is solvent and the country has a strategy to avoid a bailout, is expected to be released.	124	132	strategy	1	3	4
3SV8KD29L4T18PT2750JYLXXFKGKZC	A reform package for Spain's troubled banks, aimed at convincing investors that the sector is solvent and the country has a strategy to avoid a bailout, is expected to be released.	144	151	bailout	10	8	18
3SV8KD29L4T18PT2750JYLXXFKGKZC	A reform package for Spain's troubled banks, aimed at convincing investors that the sector is solvent and the country has a strategy to avoid a bailout, is expected to be released.	156	164	expected	0	1	1
3SV8KD29L4T18PT2750JYLXXFKGKZC	The government package is expected to include measures obliging banks to increase provisions against bad loans and possibly plans for the creation of a new entity that would act as a "bad bank".	4	22	government package	1	1	2
3SV8KD29L4T18PT2750JYLXXFKGKZC	The government package is expected to include measures obliging banks to increase provisions against bad loans and possibly plans for the creation of a new entity that would act as a "bad bank".	46	54	measures	1	0	1
3SV8KD29L4T18PT2750JYLXXFKGKZC	The government package is expected to include measures obliging banks to increase provisions against bad loans and possibly plans for the creation of a new entity that would act as a "bad bank".	55	63	obliging	7	6	13
3SV8KD29L4T18PT2750JYLXXFKGKZC	The government package is expected to include measures obliging banks to increase provisions against bad loans and possibly plans for the creation of a new entity that would act as a "bad bank".	55	69	obliging banks	1	1	2
3SV8KD29L4T18PT2750JYLXXFKGKZC	The government package is expected to include measures obliging banks to increase provisions against bad loans and possibly plans for the creation of a new entity that would act as a "bad bank".	82	92	provisions	5	2	7
3SV8KD29L4T18PT2750JYLXXFKGKZC	The government package is expected to include measures obliging banks to increase provisions against bad loans and possibly plans for the creation of a new entity that would act as a "bad bank".	82	110	provisions against bad loans	0	1	1
3SV8KD29L4T18PT2750JYLXXFKGKZC	The government package is expected to include measures obliging banks to increase provisions against bad loans and possibly plans for the creation of a new entity that would act as a "bad bank".	156	162	entity	3	2	5
3SNR5F7R92UCRZCIBF1U0VH2ZAIIET	Spain is set to present new reforms to complete the clean-up of its banks after difficult last-minute talks between the government and lenders.	28	35	reforms	6	5	11
3SNR5F7R92UCRZCIBF1U0VH2ZAIIET	Spain is set to present new reforms to complete the clean-up of its banks after difficult last-minute talks between the government and lenders.	52	60	clean-up	1	1	2
3SNR5F7R92UCRZCIBF1U0VH2ZAIIET	Spain is set to present new reforms to complete the clean-up of its banks after difficult last-minute talks between the government and lenders.	90	107	last-minute talks	0	2	2
3SNR5F7R92UCRZCIBF1U0VH2ZAIIET	Spain is set to present new reforms to complete the clean-up of its banks after difficult last-minute talks between the government and lenders.	135	142	lenders	2	7	9
3SNR5F7R92UCRZCIBF1U0VH2ZAIIET	The Spanish government is expected to approve a plan on Friday to force banks to place toxic real estate assets in holding companies that would later sell them off.	26	34	expected	0	2	2
3SNR5F7R92UCRZCIBF1U0VH2ZAIIET	The Spanish government is expected to approve a plan on Friday to force banks to place toxic real estate assets in holding companies that would later sell them off.	66	77	force banks	1	0	1
3SNR5F7R92UCRZCIBF1U0VH2ZAIIET	The Spanish government is expected to approve a plan on Friday to force banks to place toxic real estate assets in holding companies that would later sell them off.	87	92	toxic	5	5	10
3SNR5F7R92UCRZCIBF1U0VH2ZAIIET	The Spanish government is expected to approve a plan on Friday to force banks to place toxic real estate assets in holding companies that would later sell them off.	87	111	toxic real estate assets	6	2	8
3SNR5F7R92UCRZCIBF1U0VH2ZAIIET	The Spanish government is expected to approve a plan on Friday to force banks to place toxic real estate assets in holding companies that would later sell them off.	93	111	real estate assets	2	0	2
3SNR5F7R92UCRZCIBF1U0VH2ZAIIET	The Spanish government is expected to approve a plan on Friday to force banks to place toxic real estate assets in holding companies that would later sell them off.	105	111	assets	4	0	4
3SNR5F7R92UCRZCIBF1U0VH2ZAIIET	The Spanish government is expected to approve a plan on Friday to force banks to place toxic real estate assets in holding companies that would later sell them off.	115	132	holding companies	4	1	5
3SNR5F7R92UCRZCIBF1U0VH2ZAIIET	The government is also expected to announce demands for the banks to set aside a further 35bn euros ($45bn) to cover sound loans in their real estate portfolios.	35	43	announce	0	1	1
3SNR5F7R92UCRZCIBF1U0VH2ZAIIET	The government is also expected to announce demands for the banks to set aside a further 35bn euros ($45bn) to cover sound loans in their real estate portfolios.	35	51	announce demands	0	1	1
3SNR5F7R92UCRZCIBF1U0VH2ZAIIET	The government is also expected to announce demands for the banks to set aside a further 35bn euros ($45bn) to cover sound loans in their real estate portfolios.	69	78	set aside	0	1	1
3SNR5F7R92UCRZCIBF1U0VH2ZAIIET	The government is also expected to announce demands for the banks to set aside a further 35bn euros ($45bn) to cover sound loans in their real estate portfolios.	117	128	sound loans	5	1	6
3SNR5F7R92UCRZCIBF1U0VH2ZAIIET	The government is also expected to announce demands for the banks to set aside a further 35bn euros ($45bn) to cover sound loans in their real estate portfolios.	123	128	loans	0	1	1
3SNR5F7R92UCRZCIBF1U0VH2ZAIIET	The government is also expected to announce demands for the banks to set aside a further 35bn euros ($45bn) to cover sound loans in their real estate portfolios.	138	160	real estate portfolios	2	1	3
3SNR5F7R92UCRZCIBF1U0VH2ZAIIET	The government is also expected to announce demands for the banks to set aside a further 35bn euros ($45bn) to cover sound loans in their real estate portfolios.	150	160	portfolios	9	7	16
3SNR5F7R92UCRZCIBF1U0VH2ZAIIET	The government has already forced banks to make provisions of 54bn euros to cover bad assets.	48	58	provisions	9	4	13
3SNR5F7R92UCRZCIBF1U0VH2ZAIIET	The government has already forced banks to make provisions of 54bn euros to cover bad assets.	76	92	cover bad assets	0	1	1
3SNR5F7R92UCRZCIBF1U0VH2ZAIIET	The government has already forced banks to make provisions of 54bn euros to cover bad assets.	82	92	bad assets	6	2	8
3SNR5F7R92UCRZCIBF1U0VH2ZAIIET	The government has already forced banks to make provisions of 54bn euros to cover bad assets.	86	92	assets	1	2	3
3SNR5F7R92UCRZCIBF1U0VH2ZAIIET	"The text is being finalised after talks with the banks," a government source told the Reuters news agency, adding that both the new provisions and the "bad bank" scheme would be approved on Friday.	19	28	finalised	5	2	7
3SNR5F7R92UCRZCIBF1U0VH2ZAIIET	"The text is being finalised after talks with the banks," a government source told the Reuters news agency, adding that both the new provisions and the "bad bank" scheme would be approved on Friday.	87	94	Reuters	1	1	2
3SNR5F7R92UCRZCIBF1U0VH2ZAIIET	"The text is being finalised after talks with the banks," a government source told the Reuters news agency, adding that both the new provisions and the "bad bank" scheme would be approved on Friday.	129	143	new provisions	1	0	1
3SNR5F7R92UCRZCIBF1U0VH2ZAIIET	"The text is being finalised after talks with the banks," a government source told the Reuters news agency, adding that both the new provisions and the "bad bank" scheme would be approved on Friday.	133	143	provisions	7	5	12
3SNR5F7R92UCRZCIBF1U0VH2ZAIIET	"The text is being finalised after talks with the banks," a government source told the Reuters news agency, adding that both the new provisions and the "bad bank" scheme would be approved on Friday.	152	167	bad bank scheme	3	0	3
3SNR5F7R92UCRZCIBF1U0VH2ZAIIET	"The text is being finalised after talks with the banks," a government source told the Reuters news agency, adding that both the new provisions and the "bad bank" scheme would be approved on Friday.	153	161	bad bank	0	3	3
3SNR5F7R92UCRZCIBF1U0VH2ZAIIET	"The text is being finalised after talks with the banks," a government source told the Reuters news agency, adding that both the new provisions and the "bad bank" scheme would be approved on Friday.	163	169	scheme	7	1	8
3SNR5F7R92UCRZCIBF1U0VH2ZAIIET	"The text is being finalised after talks with the banks," a government source told the Reuters news agency, adding that both the new provisions and the "bad bank" scheme would be approved on Friday.	179	187	approved	0	1	1
