3QGHA0EA0J1WLRK3Q53J0EKPETVBWY	#25-13 The Fed has not increased interest rates since 2006, and during the 2007-2009 recession, it lowered rates to historically low levels.	11	14	Fed	2	1	3
3QGHA0EA0J1WLRK3Q53J0EKPETVBWY	#25-13 The Fed has not increased interest rates since 2006, and during the 2007-2009 recession, it lowered rates to historically low levels.	23	32	increased	2	0	2
3QGHA0EA0J1WLRK3Q53J0EKPETVBWY	#25-13 The Fed has not increased interest rates since 2006, and during the 2007-2009 recession, it lowered rates to historically low levels.	33	47	interest rates	2	1	3
3QGHA0EA0J1WLRK3Q53J0EKPETVBWY	#25-13 The Fed has not increased interest rates since 2006, and during the 2007-2009 recession, it lowered rates to historically low levels.	85	94	recession	8	8	16
3QGHA0EA0J1WLRK3Q53J0EKPETVBWY	#25-13 The Fed has not increased interest rates since 2006, and during the 2007-2009 recession, it lowered rates to historically low levels.	107	112	rates	0	1	1
3QGHA0EA0J1WLRK3Q53J0EKPETVBWY	#25-13 The Fed has not increased interest rates since 2006, and during the 2007-2009 recession, it lowered rates to historically low levels.	116	128	historically	4	2	6
3QGHA0EA0J1WLRK3Q53J0EKPETVBWY	#25-13 The Fed has not increased interest rates since 2006, and during the 2007-2009 recession, it lowered rates to historically low levels.	116	139	historically low levels	0	1	1
3QGHA0EA0J1WLRK3Q53J0EKPETVBWY	#26-1 Two slain in knife attack at Swedish IKEA furniture retailer The store front of the IKEA in Västerås, Sweden, where the attack occurred Two people were killed yesterday afternoon and another seriously injured in Västerås, Sweden.	10	15	slain	3	9	12
3QGHA0EA0J1WLRK3Q53J0EKPETVBWY	#26-1 Two slain in knife attack at Swedish IKEA furniture retailer The store front of the IKEA in Västerås, Sweden, where the attack occurred Two people were killed yesterday afternoon and another seriously injured in Västerås, Sweden.	35	42	Swedish	0	1	1
3QGHA0EA0J1WLRK3Q53J0EKPETVBWY	#26-1 Two slain in knife attack at Swedish IKEA furniture retailer The store front of the IKEA in Västerås, Sweden, where the attack occurred Two people were killed yesterday afternoon and another seriously injured in Västerås, Sweden.	35	66	Swedish IKEA furniture retailer	1	0	1
3QGHA0EA0J1WLRK3Q53J0EKPETVBWY	#26-1 Two slain in knife attack at Swedish IKEA furniture retailer The store front of the IKEA in Västerås, Sweden, where the attack occurred Two people were killed yesterday afternoon and another seriously injured in Västerås, Sweden.	43	47	IKEA	2	0	2
3QGHA0EA0J1WLRK3Q53J0EKPETVBWY	#26-1 Two slain in knife attack at Swedish IKEA furniture retailer The store front of the IKEA in Västerås, Sweden, where the attack occurred Two people were killed yesterday afternoon and another seriously injured in Västerås, Sweden.	48	57	furniture	1	0	1
3QGHA0EA0J1WLRK3Q53J0EKPETVBWY	#26-1 Two slain in knife attack at Swedish IKEA furniture retailer The store front of the IKEA in Västerås, Sweden, where the attack occurred Two people were killed yesterday afternoon and another seriously injured in Västerås, Sweden.	48	66	furniture retailer	0	1	1
3QGHA0EA0J1WLRK3Q53J0EKPETVBWY	#26-1 Two slain in knife attack at Swedish IKEA furniture retailer The store front of the IKEA in Västerås, Sweden, where the attack occurred Two people were killed yesterday afternoon and another seriously injured in Västerås, Sweden.	58	66	retailer	1	2	3
3QGHA0EA0J1WLRK3Q53J0EKPETVBWY	#26-1 Two slain in knife attack at Swedish IKEA furniture retailer The store front of the IKEA in Västerås, Sweden, where the attack occurred Two people were killed yesterday afternoon and another seriously injured in Västerås, Sweden.	98	106	Västerås	3	2	5
3QGHA0EA0J1WLRK3Q53J0EKPETVBWY	#26-1 Two slain in knife attack at Swedish IKEA furniture retailer The store front of the IKEA in Västerås, Sweden, where the attack occurred Two people were killed yesterday afternoon and another seriously injured in Västerås, Sweden.	133	141	occurred	1	0	1
3QGHA0EA0J1WLRK3Q53J0EKPETVBWY	#26-1 Two slain in knife attack at Swedish IKEA furniture retailer The store front of the IKEA in Västerås, Sweden, where the attack occurred Two people were killed yesterday afternoon and another seriously injured in Västerås, Sweden.	165	184	yesterday afternoon	1	0	1
3QGHA0EA0J1WLRK3Q53J0EKPETVBWY	#26-1 Two slain in knife attack at Swedish IKEA furniture retailer The store front of the IKEA in Västerås, Sweden, where the attack occurred Two people were killed yesterday afternoon and another seriously injured in Västerås, Sweden.	197	206	seriously	1	1	2
3QGHA0EA0J1WLRK3Q53J0EKPETVBWY	#26-1 Two slain in knife attack at Swedish IKEA furniture retailer The store front of the IKEA in Västerås, Sweden, where the attack occurred Two people were killed yesterday afternoon and another seriously injured in Västerås, Sweden.	197	214	seriously injured	0	1	1
3QGHA0EA0J1WLRK3Q53J0EKPETVBWY	#26-1 Two slain in knife attack at Swedish IKEA furniture retailer The store front of the IKEA in Västerås, Sweden, where the attack occurred Two people were killed yesterday afternoon and another seriously injured in Västerås, Sweden.	207	214	injured	1	0	1
3QGHA0EA0J1WLRK3Q53J0EKPETVBWY	#26-1 Two slain in knife attack at Swedish IKEA furniture retailer The store front of the IKEA in Västerås, Sweden, where the attack occurred Two people were killed yesterday afternoon and another seriously injured in Västerås, Sweden.	218	226	Västerås	1	0	1
3QGHA0EA0J1WLRK3Q53J0EKPETVBWY	#26-2 The injured man is considered a suspect in the knife attack and was arrested in hospital.	25	35	considered	2	0	2
3QGHA0EA0J1WLRK3Q53J0EKPETVBWY	#26-2 The injured man is considered a suspect in the knife attack and was arrested in hospital.	38	45	suspect	5	4	9
3QGHA0EA0J1WLRK3Q53J0EKPETVBWY	#26-2 The injured man is considered a suspect in the knife attack and was arrested in hospital.	53	58	knife	0	1	1
3QGHA0EA0J1WLRK3Q53J0EKPETVBWY	#26-2 The injured man is considered a suspect in the knife attack and was arrested in hospital.	74	82	arrested	2	0	2
3QGHA0EA0J1WLRK3Q53J0EKPETVBWY	#26-3 Another man was arrested at the scene, which was an IKEA furniture retailer.	58	62	IKEA	0	1	1
3QGHA0EA0J1WLRK3Q53J0EKPETVBWY	#26-3 Another man was arrested at the scene, which was an IKEA furniture retailer.	63	81	furniture retailer	1	1	2
3QGHA0EA0J1WLRK3Q53J0EKPETVBWY	#26-3 Another man was arrested at the scene, which was an IKEA furniture retailer.	73	81	retailer	2	2	4
3QGHA0EA0J1WLRK3Q53J0EKPETVBWY	#26-4 According to police, the two fatalities do not have any obvious connection to the suspects, but did know each other.	35	45	fatalities	9	9	18
3QGHA0EA0J1WLRK3Q53J0EKPETVBWY	#26-4 According to police, the two fatalities do not have any obvious connection to the suspects, but did know each other.	62	69	obvious	7	1	8
3QGHA0EA0J1WLRK3Q53J0EKPETVBWY	#26-4 According to police, the two fatalities do not have any obvious connection to the suspects, but did know each other.	62	80	obvious connection	0	1	1
3QGHA0EA0J1WLRK3Q53J0EKPETVBWY	#26-4 According to police, the two fatalities do not have any obvious connection to the suspects, but did know each other.	70	80	connection	1	0	1
3QGHA0EA0J1WLRK3Q53J0EKPETVBWY	#26-4 According to police, the two fatalities do not have any obvious connection to the suspects, but did know each other.	88	96	suspects	1	1	2
3QGHA0EA0J1WLRK3Q53J0EKPETVBWY	#26-5 The motive is, thus far, unknown.	10	16	motive	2	4	6
3QGHA0EA0J1WLRK3Q53J0EKPETVBWY	#26-5 The motive is, thus far, unknown.	21	29	thus far	0	1	1
3QGHA0EA0J1WLRK3Q53J0EKPETVBWY	#26-5 The motive is, thus far, unknown.	31	38	unknown	1	1	2
3QGHA0EA0J1WLRK3Q53J0EKPETVBWY	#26-6 Police were called to the scene at 13:00 local time and found three stab victims.	74	78	stab	2	5	7
3QGHA0EA0J1WLRK3Q53J0EKPETVBWY	#26-6 Police were called to the scene at 13:00 local time and found three stab victims.	74	86	stab victims	0	2	2
3QGHA0EA0J1WLRK3Q53J0EKPETVBWY	#26-6 Police were called to the scene at 13:00 local time and found three stab victims.	79	86	victims	2	1	3
3TZ0XG8CBUL27X9OUI9HVSMD8MP987	#42-89 This is probably for reducing chance of infecting nestmates, but of course it also reduces the work load of their nest-mates, as their corpse doesn't have to be dragged out etc.	15	23	probably	0	1	1
3TZ0XG8CBUL27X9OUI9HVSMD8MP987	#42-89 This is probably for reducing chance of infecting nestmates, but of course it also reduces the work load of their nest-mates, as their corpse doesn't have to be dragged out etc.	28	36	reducing	0	1	1
3TZ0XG8CBUL27X9OUI9HVSMD8MP987	#42-89 This is probably for reducing chance of infecting nestmates, but of course it also reduces the work load of their nest-mates, as their corpse doesn't have to be dragged out etc.	47	56	infecting	4	0	4
3TZ0XG8CBUL27X9OUI9HVSMD8MP987	#42-89 This is probably for reducing chance of infecting nestmates, but of course it also reduces the work load of their nest-mates, as their corpse doesn't have to be dragged out etc.	47	66	infecting nestmates	3	2	5
3TZ0XG8CBUL27X9OUI9HVSMD8MP987	#42-89 This is probably for reducing chance of infecting nestmates, but of course it also reduces the work load of their nest-mates, as their corpse doesn't have to be dragged out etc.	57	66	nestmates	10	9	19
3TZ0XG8CBUL27X9OUI9HVSMD8MP987	#42-89 This is probably for reducing chance of infecting nestmates, but of course it also reduces the work load of their nest-mates, as their corpse doesn't have to be dragged out etc.	121	131	nest-mates	5	1	6
3TZ0XG8CBUL27X9OUI9HVSMD8MP987	#42-89 This is probably for reducing chance of infecting nestmates, but of course it also reduces the work load of their nest-mates, as their corpse doesn't have to be dragged out etc.	142	148	corpse	7	5	12
3TZ0XG8CBUL27X9OUI9HVSMD8MP987	#42-89 This is probably for reducing chance of infecting nestmates, but of course it also reduces the work load of their nest-mates, as their corpse doesn't have to be dragged out etc.	168	175	dragged	2	6	8
3TZ0XG8CBUL27X9OUI9HVSMD8MP987	#42-89 This is probably for reducing chance of infecting nestmates, but of course it also reduces the work load of their nest-mates, as their corpse doesn't have to be dragged out etc.	168	179	dragged out	0	2	2
3TZ0XG8CBUL27X9OUI9HVSMD8MP987	#42-90 So as an answer to the question, I would find it unlikely that such a behaviour would evolve, but it's not known yet.	56	64	unlikely	1	0	1
3TZ0XG8CBUL27X9OUI9HVSMD8MP987	#42-90 So as an answer to the question, I would find it unlikely that such a behaviour would evolve, but it's not known yet.	77	86	behaviour	5	4	9
3TZ0XG8CBUL27X9OUI9HVSMD8MP987	#42-90 So as an answer to the question, I would find it unlikely that such a behaviour would evolve, but it's not known yet.	93	99	evolve	4	3	7
3TZ0XG8CBUL27X9OUI9HVSMD8MP987	#42-91 Wikinews: Ants generally avoided the peroxide if they were healthy, but in some circumstances might they try to build resistance against infection in advance?	32	39	avoided	0	2	2
3TZ0XG8CBUL27X9OUI9HVSMD8MP987	#42-91 Wikinews: Ants generally avoided the peroxide if they were healthy, but in some circumstances might they try to build resistance against infection in advance?	44	52	peroxide	10	4	14
3TZ0XG8CBUL27X9OUI9HVSMD8MP987	#42-91 Wikinews: Ants generally avoided the peroxide if they were healthy, but in some circumstances might they try to build resistance against infection in advance?	87	100	circumstances	8	2	10
3TZ0XG8CBUL27X9OUI9HVSMD8MP987	#42-91 Wikinews: Ants generally avoided the peroxide if they were healthy, but in some circumstances might they try to build resistance against infection in advance?	125	135	resistance	7	8	15
3TZ0XG8CBUL27X9OUI9HVSMD8MP987	#42-91 Wikinews: Ants generally avoided the peroxide if they were healthy, but in some circumstances might they try to build resistance against infection in advance?	144	153	infection	4	2	6
3TZ0XG8CBUL27X9OUI9HVSMD8MP987	#42-93 Also not known yet unfortunately.	26	39	unfortunately	3	5	8
3TZ0XG8CBUL27X9OUI9HVSMD8MP987	#42-94 That said, there is a very interesting study about resin collection in ants.	58	63	resin	9	1	10
3TZ0XG8CBUL27X9OUI9HVSMD8MP987	#42-94 That said, there is a very interesting study about resin collection in ants.	58	74	resin collection	0	3	3
3TZ0XG8CBUL27X9OUI9HVSMD8MP987	#42-94 That said, there is a very interesting study about resin collection in ants.	64	74	collection	1	0	1
3TZ0XG8CBUL27X9OUI9HVSMD8MP987	#42-95 Wood ants collect tree-resin, which has anti-microbial properties.	25	35	tree-resin	4	2	6
3TZ0XG8CBUL27X9OUI9HVSMD8MP987	#42-95 Wood ants collect tree-resin, which has anti-microbial properties.	47	61	anti-microbial	10	4	14
3TZ0XG8CBUL27X9OUI9HVSMD8MP987	#42-95 Wood ants collect tree-resin, which has anti-microbial properties.	47	72	anti-microbial properties	2	2	4
3TZ0XG8CBUL27X9OUI9HVSMD8MP987	#42-96 They collect this even if not infected, and when you infect them, they don't collect more of the resin than normal.	104	109	resin	4	2	6
3QMELQS6Y5CL7JMMVKC52ZQG8D56R5	#2-7 The impoverished region, in the northeast of the nation, has suffered severe famine as conflict interrupts agriculture.	9	21	impoverished	10	10	20
3QMELQS6Y5CL7JMMVKC52ZQG8D56R5	#2-7 The impoverished region, in the northeast of the nation, has suffered severe famine as conflict interrupts agriculture.	9	28	impoverished region	1	1	2
3QMELQS6Y5CL7JMMVKC52ZQG8D56R5	#2-7 The impoverished region, in the northeast of the nation, has suffered severe famine as conflict interrupts agriculture.	66	74	suffered	3	0	3
3QMELQS6Y5CL7JMMVKC52ZQG8D56R5	#2-7 The impoverished region, in the northeast of the nation, has suffered severe famine as conflict interrupts agriculture.	75	81	severe	1	1	2
3QMELQS6Y5CL7JMMVKC52ZQG8D56R5	#2-7 The impoverished region, in the northeast of the nation, has suffered severe famine as conflict interrupts agriculture.	75	88	severe famine	3	2	5
3QMELQS6Y5CL7JMMVKC52ZQG8D56R5	#2-7 The impoverished region, in the northeast of the nation, has suffered severe famine as conflict interrupts agriculture.	82	88	famine	8	9	17
3QMELQS6Y5CL7JMMVKC52ZQG8D56R5	#2-7 The impoverished region, in the northeast of the nation, has suffered severe famine as conflict interrupts agriculture.	92	100	conflict	4	2	6
3QMELQS6Y5CL7JMMVKC52ZQG8D56R5	#2-7 The impoverished region, in the northeast of the nation, has suffered severe famine as conflict interrupts agriculture.	92	111	conflict interrupts	0	1	1
3QMELQS6Y5CL7JMMVKC52ZQG8D56R5	#2-7 The impoverished region, in the northeast of the nation, has suffered severe famine as conflict interrupts agriculture.	92	123	conflict interrupts agriculture	1	0	1
3QMELQS6Y5CL7JMMVKC52ZQG8D56R5	#2-7 The impoverished region, in the northeast of the nation, has suffered severe famine as conflict interrupts agriculture.	101	111	interrupts	3	4	7
3QMELQS6Y5CL7JMMVKC52ZQG8D56R5	#2-7 The impoverished region, in the northeast of the nation, has suffered severe famine as conflict interrupts agriculture.	101	123	interrupts agriculture	1	0	1
3QMELQS6Y5CL7JMMVKC52ZQG8D56R5	#2-7 The impoverished region, in the northeast of the nation, has suffered severe famine as conflict interrupts agriculture.	112	123	agriculture	5	0	5
3QMELQS6Y5CL7JMMVKC52ZQG8D56R5	#2-8 Farmers are unable to work owing to bombs on their land.	32	37	owing	3	3	6
3QMELQS6Y5CL7JMMVKC52ZQG8D56R5	#2-8 Farmers are unable to work owing to bombs on their land.	32	40	owing to	1	0	1
3QMELQS6Y5CL7JMMVKC52ZQG8D56R5	#2-8 Farmers are unable to work owing to bombs on their land.	41	46	bombs	1	0	1
3QMELQS6Y5CL7JMMVKC52ZQG8D56R5	#2-9 The Red Cross said volunteers were at the camp, home to thousands, to distribute food.	24	34	volunteers	7	2	9
3QMELQS6Y5CL7JMMVKC52ZQG8D56R5	#2-9 The Red Cross said volunteers were at the camp, home to thousands, to distribute food.	75	85	distribute	5	1	6
3QMELQS6Y5CL7JMMVKC52ZQG8D56R5	#2-10 The military said the Air Force was dispatched to deal with "remnants" of the Boko Haram militant group, which it claims to be in a final push against.	42	52	dispatched	6	5	11
3QMELQS6Y5CL7JMMVKC52ZQG8D56R5	#2-10 The military said the Air Force was dispatched to deal with "remnants" of the Boko Haram militant group, which it claims to be in a final push against.	67	75	remnants	7	1	8
3QMELQS6Y5CL7JMMVKC52ZQG8D56R5	#2-10 The military said the Air Force was dispatched to deal with "remnants" of the Boko Haram militant group, which it claims to be in a final push against.	84	109	Boko Haram militant group	1	0	1
3QMELQS6Y5CL7JMMVKC52ZQG8D56R5	#2-10 The military said the Air Force was dispatched to deal with "remnants" of the Boko Haram militant group, which it claims to be in a final push against.	95	103	militant	1	1	2
3QMELQS6Y5CL7JMMVKC52ZQG8D56R5	#2-10 The military said the Air Force was dispatched to deal with "remnants" of the Boko Haram militant group, which it claims to be in a final push against.	120	126	claims	0	1	1
3QMELQS6Y5CL7JMMVKC52ZQG8D56R5	#2-10 The military said the Air Force was dispatched to deal with "remnants" of the Boko Haram militant group, which it claims to be in a final push against.	138	148	final push	1	0	1
3QMELQS6Y5CL7JMMVKC52ZQG8D56R5	#2-10 The military said the Air Force was dispatched to deal with "remnants" of the Boko Haram militant group, which it claims to be in a final push against.	138	156	final push against	1	0	1
3QMELQS6Y5CL7JMMVKC52ZQG8D56R5	#2-11 Major General Leo Irabor, who led the operation, said "Unfortunately, the strike was conducted but it turned out that other civilians were somewhere around the area and they were affected".	44	53	operation	1	0	1
3QMELQS6Y5CL7JMMVKC52ZQG8D56R5	#2-11 Major General Leo Irabor, who led the operation, said "Unfortunately, the strike was conducted but it turned out that other civilians were somewhere around the area and they were affected".	61	74	Unfortunately	4	0	4
3QMELQS6Y5CL7JMMVKC52ZQG8D56R5	#2-11 Major General Leo Irabor, who led the operation, said "Unfortunately, the strike was conducted but it turned out that other civilians were somewhere around the area and they were affected".	80	86	strike	1	1	2
3QMELQS6Y5CL7JMMVKC52ZQG8D56R5	#2-11 Major General Leo Irabor, who led the operation, said "Unfortunately, the strike was conducted but it turned out that other civilians were somewhere around the area and they were affected".	80	100	strike was conducted	1	0	1
3QMELQS6Y5CL7JMMVKC52ZQG8D56R5	#2-11 Major General Leo Irabor, who led the operation, said "Unfortunately, the strike was conducted but it turned out that other civilians were somewhere around the area and they were affected".	91	100	conducted	2	1	3
3QMELQS6Y5CL7JMMVKC52ZQG8D56R5	#2-11 Major General Leo Irabor, who led the operation, said "Unfortunately, the strike was conducted but it turned out that other civilians were somewhere around the area and they were affected".	130	139	civilians	3	1	4
3QMELQS6Y5CL7JMMVKC52ZQG8D56R5	#2-11 Major General Leo Irabor, who led the operation, said "Unfortunately, the strike was conducted but it turned out that other civilians were somewhere around the area and they were affected".	185	193	affected	1	1	2
3QMELQS6Y5CL7JMMVKC52ZQG8D56R5	#2-12 Irabor said two soldiers were amongst the dead and others were wounded.	36	43	amongst	4	5	9
3QMELQS6Y5CL7JMMVKC52ZQG8D56R5	#2-12 Irabor said two soldiers were amongst the dead and others were wounded.	69	76	wounded	1	3	4
3QMELQS6Y5CL7JMMVKC52ZQG8D56R5	#2-13 Military spokesman General Rabe Abubakar said the military are "all in pain" after the disaster, adding "in a military operation such as this, from time to time these things do occur."	15	24	spokesman	1	1	2
3QMELQS6Y5CL7JMMVKC52ZQG8D56R5	#2-13 Military spokesman General Rabe Abubakar said the military are "all in pain" after the disaster, adding "in a military operation such as this, from time to time these things do occur."	93	101	disaster	2	4	6
3QMELQS6Y5CL7JMMVKC52ZQG8D56R5	#2-13 Military spokesman General Rabe Abubakar said the military are "all in pain" after the disaster, adding "in a military operation such as this, from time to time these things do occur."	125	134	operation	4	0	4
3QMELQS6Y5CL7JMMVKC52ZQG8D56R5	#2-13 Military spokesman General Rabe Abubakar said the military are "all in pain" after the disaster, adding "in a military operation such as this, from time to time these things do occur."	183	188	occur	2	1	3
3K2CEDRACB20C1K6MPOHRAOKMYGTME	#35-31 This is not a Report which contains, for instance, state secrets."	34	42	contains	1	0	1
3K2CEDRACB20C1K6MPOHRAOKMYGTME	#35-31 This is not a Report which contains, for instance, state secrets."	48	56	instance	4	3	7
3K2CEDRACB20C1K6MPOHRAOKMYGTME	#35-31 This is not a Report which contains, for instance, state secrets."	64	71	secrets	1	0	1
3K2CEDRACB20C1K6MPOHRAOKMYGTME	#35-32 He also spoke of his distance from the ongoing trial, prompting him to remark of his "very considerable unease" and having to do "the best I could" — not "a comfortable process".	28	36	distance	0	1	1
3K2CEDRACB20C1K6MPOHRAOKMYGTME	#35-32 He also spoke of his distance from the ongoing trial, prompting him to remark of his "very considerable unease" and having to do "the best I could" — not "a comfortable process".	46	53	ongoing	3	6	9
3K2CEDRACB20C1K6MPOHRAOKMYGTME	#35-32 He also spoke of his distance from the ongoing trial, prompting him to remark of his "very considerable unease" and having to do "the best I could" — not "a comfortable process".	54	59	trial	0	1	1
3K2CEDRACB20C1K6MPOHRAOKMYGTME	#35-32 He also spoke of his distance from the ongoing trial, prompting him to remark of his "very considerable unease" and having to do "the best I could" — not "a comfortable process".	61	70	prompting	4	8	12
3K2CEDRACB20C1K6MPOHRAOKMYGTME	#35-32 He also spoke of his distance from the ongoing trial, prompting him to remark of his "very considerable unease" and having to do "the best I could" — not "a comfortable process".	78	84	remark	1	1	2
3K2CEDRACB20C1K6MPOHRAOKMYGTME	#35-32 He also spoke of his distance from the ongoing trial, prompting him to remark of his "very considerable unease" and having to do "the best I could" — not "a comfortable process".	93	117	very considerable unease	2	0	2
3K2CEDRACB20C1K6MPOHRAOKMYGTME	#35-32 He also spoke of his distance from the ongoing trial, prompting him to remark of his "very considerable unease" and having to do "the best I could" — not "a comfortable process".	98	110	considerable	3	0	3
3K2CEDRACB20C1K6MPOHRAOKMYGTME	#35-32 He also spoke of his distance from the ongoing trial, prompting him to remark of his "very considerable unease" and having to do "the best I could" — not "a comfortable process".	98	117	considerable unease	2	3	5
3K2CEDRACB20C1K6MPOHRAOKMYGTME	#35-32 He also spoke of his distance from the ongoing trial, prompting him to remark of his "very considerable unease" and having to do "the best I could" — not "a comfortable process".	111	117	unease	4	4	8
3K2CEDRACB20C1K6MPOHRAOKMYGTME	#35-32 He also spoke of his distance from the ongoing trial, prompting him to remark of his "very considerable unease" and having to do "the best I could" — not "a comfortable process".	164	183	comfortable process	2	1	3
3K2CEDRACB20C1K6MPOHRAOKMYGTME	#35-33 Noting "the issues of both law and fact are complex, novel and difficult" Mr Justice Green's judgement notes that, before even hearing the case he promised permission to appeal would be granted, if requested, whatever the outcome.	19	25	issues	1	0	1
3K2CEDRACB20C1K6MPOHRAOKMYGTME	#35-33 Noting "the issues of both law and fact are complex, novel and difficult" Mr Justice Green's judgement notes that, before even hearing the case he promised permission to appeal would be granted, if requested, whatever the outcome.	51	58	complex	5	1	6
3K2CEDRACB20C1K6MPOHRAOKMYGTME	#35-33 Noting "the issues of both law and fact are complex, novel and difficult" Mr Justice Green's judgement notes that, before even hearing the case he promised permission to appeal would be granted, if requested, whatever the outcome.	60	65	novel	4	1	5
3K2CEDRACB20C1K6MPOHRAOKMYGTME	#35-33 Noting "the issues of both law and fact are complex, novel and difficult" Mr Justice Green's judgement notes that, before even hearing the case he promised permission to appeal would be granted, if requested, whatever the outcome.	100	109	judgement	2	1	3
3K2CEDRACB20C1K6MPOHRAOKMYGTME	#35-33 Noting "the issues of both law and fact are complex, novel and difficult" Mr Justice Green's judgement notes that, before even hearing the case he promised permission to appeal would be granted, if requested, whatever the outcome.	134	141	hearing	0	2	2
3K2CEDRACB20C1K6MPOHRAOKMYGTME	#35-33 Noting "the issues of both law and fact are complex, novel and difficult" Mr Justice Green's judgement notes that, before even hearing the case he promised permission to appeal would be granted, if requested, whatever the outcome.	154	173	promised permission	0	1	1
3K2CEDRACB20C1K6MPOHRAOKMYGTME	#35-33 Noting "the issues of both law and fact are complex, novel and difficult" Mr Justice Green's judgement notes that, before even hearing the case he promised permission to appeal would be granted, if requested, whatever the outcome.	163	173	permission	4	1	5
3K2CEDRACB20C1K6MPOHRAOKMYGTME	#35-33 Noting "the issues of both law and fact are complex, novel and difficult" Mr Justice Green's judgement notes that, before even hearing the case he promised permission to appeal would be granted, if requested, whatever the outcome.	177	183	appeal	2	3	5
3K2CEDRACB20C1K6MPOHRAOKMYGTME	#35-33 Noting "the issues of both law and fact are complex, novel and difficult" Mr Justice Green's judgement notes that, before even hearing the case he promised permission to appeal would be granted, if requested, whatever the outcome.	193	200	granted	0	2	2
3K2CEDRACB20C1K6MPOHRAOKMYGTME	#35-33 Noting "the issues of both law and fact are complex, novel and difficult" Mr Justice Green's judgement notes that, before even hearing the case he promised permission to appeal would be granted, if requested, whatever the outcome.	205	214	requested	0	1	1
3K2CEDRACB20C1K6MPOHRAOKMYGTME	#35-33 Noting "the issues of both law and fact are complex, novel and difficult" Mr Justice Green's judgement notes that, before even hearing the case he promised permission to appeal would be granted, if requested, whatever the outcome.	229	236	outcome	1	4	5
3K2CEDRACB20C1K6MPOHRAOKMYGTME	#35-34 He also promised a swift Court of Appeal hearing to comply with Thai trial time constraints.	26	31	swift	0	2	2
3K2CEDRACB20C1K6MPOHRAOKMYGTME	#35-34 He also promised a swift Court of Appeal hearing to comply with Thai trial time constraints.	26	37	swift Court	0	1	1
3K2CEDRACB20C1K6MPOHRAOKMYGTME	#35-34 He also promised a swift Court of Appeal hearing to comply with Thai trial time constraints.	41	47	Appeal	1	0	1
3K2CEDRACB20C1K6MPOHRAOKMYGTME	#35-34 He also promised a swift Court of Appeal hearing to comply with Thai trial time constraints.	48	55	hearing	0	1	1
3K2CEDRACB20C1K6MPOHRAOKMYGTME	#35-34 He also promised a swift Court of Appeal hearing to comply with Thai trial time constraints.	59	65	comply	2	3	5
3K2CEDRACB20C1K6MPOHRAOKMYGTME	#35-34 He also promised a swift Court of Appeal hearing to comply with Thai trial time constraints.	71	75	Thai	0	1	1
3K2CEDRACB20C1K6MPOHRAOKMYGTME	#35-34 He also promised a swift Court of Appeal hearing to comply with Thai trial time constraints.	87	98	constraints	10	9	19
3K2CEDRACB20C1K6MPOHRAOKMYGTME	#35-35 "The stakes are very high for both sides", he added.	12	18	stakes	3	5	8
3K2CEDRACB20C1K6MPOHRAOKMYGTME	#35-36 "In my judgment the common law," the judgement reads, "and in particular the principles of natural justice and fairness, would in a case such as this which involves the right to life, and the right to a fair trial, as well as powerful countervailing issues of public interest, compel the court to apply the most intense level of anxious scrutiny to the facts to ensure that the accused were not prejudiced."	27	37	common law	1	0	1
3K2CEDRACB20C1K6MPOHRAOKMYGTME	#35-36 "In my judgment the common law," the judgement reads, "and in particular the principles of natural justice and fairness, would in a case such as this which involves the right to life, and the right to a fair trial, as well as powerful countervailing issues of public interest, compel the court to apply the most intense level of anxious scrutiny to the facts to ensure that the accused were not prejudiced."	84	94	principles	0	1	1
3K2CEDRACB20C1K6MPOHRAOKMYGTME	#35-36 "In my judgment the common law," the judgement reads, "and in particular the principles of natural justice and fairness, would in a case such as this which involves the right to life, and the right to a fair trial, as well as powerful countervailing issues of public interest, compel the court to apply the most intense level of anxious scrutiny to the facts to ensure that the accused were not prejudiced."	84	113	principles of natural justice	1	0	1
3K2CEDRACB20C1K6MPOHRAOKMYGTME	#35-36 "In my judgment the common law," the judgement reads, "and in particular the principles of natural justice and fairness, would in a case such as this which involves the right to life, and the right to a fair trial, as well as powerful countervailing issues of public interest, compel the court to apply the most intense level of anxious scrutiny to the facts to ensure that the accused were not prejudiced."	98	113	natural justice	1	1	2
3K2CEDRACB20C1K6MPOHRAOKMYGTME	#35-36 "In my judgment the common law," the judgement reads, "and in particular the principles of natural justice and fairness, would in a case such as this which involves the right to life, and the right to a fair trial, as well as powerful countervailing issues of public interest, compel the court to apply the most intense level of anxious scrutiny to the facts to ensure that the accused were not prejudiced."	106	113	justice	2	0	2
3K2CEDRACB20C1K6MPOHRAOKMYGTME	#35-36 "In my judgment the common law," the judgement reads, "and in particular the principles of natural justice and fairness, would in a case such as this which involves the right to life, and the right to a fair trial, as well as powerful countervailing issues of public interest, compel the court to apply the most intense level of anxious scrutiny to the facts to ensure that the accused were not prejudiced."	118	126	fairness	1	3	4
3K2CEDRACB20C1K6MPOHRAOKMYGTME	#35-36 "In my judgment the common law," the judgement reads, "and in particular the principles of natural justice and fairness, would in a case such as this which involves the right to life, and the right to a fair trial, as well as powerful countervailing issues of public interest, compel the court to apply the most intense level of anxious scrutiny to the facts to ensure that the accused were not prejudiced."	215	220	trial	1	0	1
3K2CEDRACB20C1K6MPOHRAOKMYGTME	#35-36 "In my judgment the common law," the judgement reads, "and in particular the principles of natural justice and fairness, would in a case such as this which involves the right to life, and the right to a fair trial, as well as powerful countervailing issues of public interest, compel the court to apply the most intense level of anxious scrutiny to the facts to ensure that the accused were not prejudiced."	242	256	countervailing	10	10	20
3K2CEDRACB20C1K6MPOHRAOKMYGTME	#35-36 "In my judgment the common law," the judgement reads, "and in particular the principles of natural justice and fairness, would in a case such as this which involves the right to life, and the right to a fair trial, as well as powerful countervailing issues of public interest, compel the court to apply the most intense level of anxious scrutiny to the facts to ensure that the accused were not prejudiced."	242	263	countervailing issues	2	0	2
3K2CEDRACB20C1K6MPOHRAOKMYGTME	#35-36 "In my judgment the common law," the judgement reads, "and in particular the principles of natural justice and fairness, would in a case such as this which involves the right to life, and the right to a fair trial, as well as powerful countervailing issues of public interest, compel the court to apply the most intense level of anxious scrutiny to the facts to ensure that the accused were not prejudiced."	284	290	compel	2	1	3
3K2CEDRACB20C1K6MPOHRAOKMYGTME	#35-36 "In my judgment the common law," the judgement reads, "and in particular the principles of natural justice and fairness, would in a case such as this which involves the right to life, and the right to a fair trial, as well as powerful countervailing issues of public interest, compel the court to apply the most intense level of anxious scrutiny to the facts to ensure that the accused were not prejudiced."	319	326	intense	0	1	1
3K2CEDRACB20C1K6MPOHRAOKMYGTME	#35-36 "In my judgment the common law," the judgement reads, "and in particular the principles of natural justice and fairness, would in a case such as this which involves the right to life, and the right to a fair trial, as well as powerful countervailing issues of public interest, compel the court to apply the most intense level of anxious scrutiny to the facts to ensure that the accused were not prejudiced."	336	343	anxious	3	1	4
3K2CEDRACB20C1K6MPOHRAOKMYGTME	#35-36 "In my judgment the common law," the judgement reads, "and in particular the principles of natural justice and fairness, would in a case such as this which involves the right to life, and the right to a fair trial, as well as powerful countervailing issues of public interest, compel the court to apply the most intense level of anxious scrutiny to the facts to ensure that the accused were not prejudiced."	336	352	anxious scrutiny	7	1	8
3K2CEDRACB20C1K6MPOHRAOKMYGTME	#35-36 "In my judgment the common law," the judgement reads, "and in particular the principles of natural justice and fairness, would in a case such as this which involves the right to life, and the right to a fair trial, as well as powerful countervailing issues of public interest, compel the court to apply the most intense level of anxious scrutiny to the facts to ensure that the accused were not prejudiced."	344	352	scrutiny	8	4	12
3K2CEDRACB20C1K6MPOHRAOKMYGTME	#35-36 "In my judgment the common law," the judgement reads, "and in particular the principles of natural justice and fairness, would in a case such as this which involves the right to life, and the right to a fair trial, as well as powerful countervailing issues of public interest, compel the court to apply the most intense level of anxious scrutiny to the facts to ensure that the accused were not prejudiced."	385	392	accused	4	2	6
3K2CEDRACB20C1K6MPOHRAOKMYGTME	#35-36 "In my judgment the common law," the judgement reads, "and in particular the principles of natural justice and fairness, would in a case such as this which involves the right to life, and the right to a fair trial, as well as powerful countervailing issues of public interest, compel the court to apply the most intense level of anxious scrutiny to the facts to ensure that the accused were not prejudiced."	402	412	prejudiced	10	8	18
33K3E8REWWWS8TRMXYFVBV8VFPG8XP	#12-8 Police sent several vehicles to the scene and 25 firefighters attended.	26	34	vehicles	4	0	4
33K3E8REWWWS8TRMXYFVBV8VFPG8XP	#12-8 Police sent several vehicles to the scene and 25 firefighters attended.	42	47	scene	1	0	1
33K3E8REWWWS8TRMXYFVBV8VFPG8XP	#12-8 Police sent several vehicles to the scene and 25 firefighters attended.	55	67	firefighters	2	8	10
33K3E8REWWWS8TRMXYFVBV8VFPG8XP	#12-8 Police sent several vehicles to the scene and 25 firefighters attended.	68	76	attended	1	1	2
33K3E8REWWWS8TRMXYFVBV8VFPG8XP	#12-9 An air ambulance also responded.	13	22	ambulance	3	0	3
33K3E8REWWWS8TRMXYFVBV8VFPG8XP	#12-9 An air ambulance also responded.	28	37	responded	1	4	5
33K3E8REWWWS8TRMXYFVBV8VFPG8XP	#12-10 Workers with cranes toiled overnight to clear the road, which provides access to London as well as the Channel Tunnel and Port of Dover.	20	26	cranes	2	3	5
33K3E8REWWWS8TRMXYFVBV8VFPG8XP	#12-10 Workers with cranes toiled overnight to clear the road, which provides access to London as well as the Channel Tunnel and Port of Dover.	27	33	toiled	6	6	12
33K3E8REWWWS8TRMXYFVBV8VFPG8XP	#12-10 Workers with cranes toiled overnight to clear the road, which provides access to London as well as the Channel Tunnel and Port of Dover.	27	43	toiled overnight	0	1	1
33K3E8REWWWS8TRMXYFVBV8VFPG8XP	#12-10 Workers with cranes toiled overnight to clear the road, which provides access to London as well as the Channel Tunnel and Port of Dover.	34	43	overnight	2	5	7
33K3E8REWWWS8TRMXYFVBV8VFPG8XP	#12-10 Workers with cranes toiled overnight to clear the road, which provides access to London as well as the Channel Tunnel and Port of Dover.	78	84	access	2	1	3
33K3E8REWWWS8TRMXYFVBV8VFPG8XP	#12-10 Workers with cranes toiled overnight to clear the road, which provides access to London as well as the Channel Tunnel and Port of Dover.	137	142	Dover	0	1	1
33K3E8REWWWS8TRMXYFVBV8VFPG8XP	#12-11 The road was again closed one week later to collect the fallen bridge sections, which were sent to Highways England depots for investigators.	63	85	fallen bridge sections	0	1	1
33K3E8REWWWS8TRMXYFVBV8VFPG8XP	#12-11 The road was again closed one week later to collect the fallen bridge sections, which were sent to Highways England depots for investigators.	106	129	Highways England depots	1	0	1
33K3E8REWWWS8TRMXYFVBV8VFPG8XP	#12-11 The road was again closed one week later to collect the fallen bridge sections, which were sent to Highways England depots for investigators.	123	129	depots	6	5	11
33K3E8REWWWS8TRMXYFVBV8VFPG8XP	#12-11 The road was again closed one week later to collect the fallen bridge sections, which were sent to Highways England depots for investigators.	134	147	investigators	8	4	12
33K3E8REWWWS8TRMXYFVBV8VFPG8XP	#12-12 The collapse occurred on one of the busiest days of the year for the local road network.	11	19	collapse	5	4	9
33K3E8REWWWS8TRMXYFVBV8VFPG8XP	#12-12 The collapse occurred on one of the busiest days of the year for the local road network.	20	28	occurred	1	1	2
33K3E8REWWWS8TRMXYFVBV8VFPG8XP	#12-12 The collapse occurred on one of the busiest days of the year for the local road network.	43	50	busiest	1	1	2
33K3E8REWWWS8TRMXYFVBV8VFPG8XP	#12-12 The collapse occurred on one of the busiest days of the year for the local road network.	76	94	local road network	1	0	1
33K3E8REWWWS8TRMXYFVBV8VFPG8XP	#13-1 Late-night vote sets Obamacare up for filibuster-free repeal At 1:30 a.m. on Thursday morning the United States Senate voted to include the repeal of the Affordable Care Act, better known as Obamacare, as part of a budget blueprint.	27	36	Obamacare	2	0	2
33K3E8REWWWS8TRMXYFVBV8VFPG8XP	#13-1 Late-night vote sets Obamacare up for filibuster-free repeal At 1:30 a.m. on Thursday morning the United States Senate voted to include the repeal of the Affordable Care Act, better known as Obamacare, as part of a budget blueprint.	44	59	filibuster-free	6	7	13
33K3E8REWWWS8TRMXYFVBV8VFPG8XP	#13-1 Late-night vote sets Obamacare up for filibuster-free repeal At 1:30 a.m. on Thursday morning the United States Senate voted to include the repeal of the Affordable Care Act, better known as Obamacare, as part of a budget blueprint.	44	66	filibuster-free repeal	3	2	5
33K3E8REWWWS8TRMXYFVBV8VFPG8XP	#13-1 Late-night vote sets Obamacare up for filibuster-free repeal At 1:30 a.m. on Thursday morning the United States Senate voted to include the repeal of the Affordable Care Act, better known as Obamacare, as part of a budget blueprint.	60	66	repeal	5	2	7
33K3E8REWWWS8TRMXYFVBV8VFPG8XP	#13-1 Late-night vote sets Obamacare up for filibuster-free repeal At 1:30 a.m. on Thursday morning the United States Senate voted to include the repeal of the Affordable Care Act, better known as Obamacare, as part of a budget blueprint.	118	124	Senate	1	2	3
33K3E8REWWWS8TRMXYFVBV8VFPG8XP	#13-1 Late-night vote sets Obamacare up for filibuster-free repeal At 1:30 a.m. on Thursday morning the United States Senate voted to include the repeal of the Affordable Care Act, better known as Obamacare, as part of a budget blueprint.	146	152	repeal	3	3	6
33K3E8REWWWS8TRMXYFVBV8VFPG8XP	#13-1 Late-night vote sets Obamacare up for filibuster-free repeal At 1:30 a.m. on Thursday morning the United States Senate voted to include the repeal of the Affordable Care Act, better known as Obamacare, as part of a budget blueprint.	160	170	Affordable	0	3	3
33K3E8REWWWS8TRMXYFVBV8VFPG8XP	#13-1 Late-night vote sets Obamacare up for filibuster-free repeal At 1:30 a.m. on Thursday morning the United States Senate voted to include the repeal of the Affordable Care Act, better known as Obamacare, as part of a budget blueprint.	160	179	Affordable Care Act	2	0	2
33K3E8REWWWS8TRMXYFVBV8VFPG8XP	#13-1 Late-night vote sets Obamacare up for filibuster-free repeal At 1:30 a.m. on Thursday morning the United States Senate voted to include the repeal of the Affordable Care Act, better known as Obamacare, as part of a budget blueprint.	197	206	Obamacare	1	0	1
33K3E8REWWWS8TRMXYFVBV8VFPG8XP	#13-1 Late-night vote sets Obamacare up for filibuster-free repeal At 1:30 a.m. on Thursday morning the United States Senate voted to include the repeal of the Affordable Care Act, better known as Obamacare, as part of a budget blueprint.	221	227	budget	1	1	2
33K3E8REWWWS8TRMXYFVBV8VFPG8XP	#13-1 Late-night vote sets Obamacare up for filibuster-free repeal At 1:30 a.m. on Thursday morning the United States Senate voted to include the repeal of the Affordable Care Act, better known as Obamacare, as part of a budget blueprint.	221	237	budget blueprint	2	2	4
33K3E8REWWWS8TRMXYFVBV8VFPG8XP	#13-1 Late-night vote sets Obamacare up for filibuster-free repeal At 1:30 a.m. on Thursday morning the United States Senate voted to include the repeal of the Affordable Care Act, better known as Obamacare, as part of a budget blueprint.	228	237	blueprint	3	8	11
33K3E8REWWWS8TRMXYFVBV8VFPG8XP	#13-2 This procedural measure allows most of Obamacare to be repealed by a simple majority rather than the usual requirement of 60 out of the senate's 100 votes and effectively prevents the use of filibuster.	11	21	procedural	4	1	5
33K3E8REWWWS8TRMXYFVBV8VFPG8XP	#13-2 This procedural measure allows most of Obamacare to be repealed by a simple majority rather than the usual requirement of 60 out of the senate's 100 votes and effectively prevents the use of filibuster.	11	29	procedural measure	2	1	3
33K3E8REWWWS8TRMXYFVBV8VFPG8XP	#13-2 This procedural measure allows most of Obamacare to be repealed by a simple majority rather than the usual requirement of 60 out of the senate's 100 votes and effectively prevents the use of filibuster.	61	69	repealed	3	4	7
33K3E8REWWWS8TRMXYFVBV8VFPG8XP	#13-2 This procedural measure allows most of Obamacare to be repealed by a simple majority rather than the usual requirement of 60 out of the senate's 100 votes and effectively prevents the use of filibuster.	82	90	majority	2	0	2
33K3E8REWWWS8TRMXYFVBV8VFPG8XP	#13-2 This procedural measure allows most of Obamacare to be repealed by a simple majority rather than the usual requirement of 60 out of the senate's 100 votes and effectively prevents the use of filibuster.	107	124	usual requirement	0	1	1
33K3E8REWWWS8TRMXYFVBV8VFPG8XP	#13-2 This procedural measure allows most of Obamacare to be repealed by a simple majority rather than the usual requirement of 60 out of the senate's 100 votes and effectively prevents the use of filibuster.	113	124	requirement	2	0	2
33K3E8REWWWS8TRMXYFVBV8VFPG8XP	#13-2 This procedural measure allows most of Obamacare to be repealed by a simple majority rather than the usual requirement of 60 out of the senate's 100 votes and effectively prevents the use of filibuster.	165	176	effectively	0	2	2
33K3E8REWWWS8TRMXYFVBV8VFPG8XP	#13-2 This procedural measure allows most of Obamacare to be repealed by a simple majority rather than the usual requirement of 60 out of the senate's 100 votes and effectively prevents the use of filibuster.	197	207	filibuster	9	7	16
3XAOZ9UYRZSQOW6PCZBO2DPU4GN1Q1	#16-7 The hashtag "#BROTUS," a play on the acronym for President of the United States (POTUS), was a common sight on Twitter in 2016.	10	17	hashtag	5	5	10
3XAOZ9UYRZSQOW6PCZBO2DPU4GN1Q1	#16-7 The hashtag "#BROTUS," a play on the acronym for President of the United States (POTUS), was a common sight on Twitter in 2016.	43	50	acronym	10	5	15
3XAOZ9UYRZSQOW6PCZBO2DPU4GN1Q1	#16-7 The hashtag "#BROTUS," a play on the acronym for President of the United States (POTUS), was a common sight on Twitter in 2016.	55	64	President	1	0	1
3XAOZ9UYRZSQOW6PCZBO2DPU4GN1Q1	#16-7 The hashtag "#BROTUS," a play on the acronym for President of the United States (POTUS), was a common sight on Twitter in 2016.	108	113	sight	0	1	1
3XAOZ9UYRZSQOW6PCZBO2DPU4GN1Q1	#17-1 US Supreme Court declares same-sex marriage legal lared same-sex marriage legal in all fifty US states.	9	16	Supreme	1	0	1
3XAOZ9UYRZSQOW6PCZBO2DPU4GN1Q1	#17-1 US Supreme Court declares same-sex marriage legal lared same-sex marriage legal in all fifty US states.	23	31	declares	0	2	2
3XAOZ9UYRZSQOW6PCZBO2DPU4GN1Q1	#17-1 US Supreme Court declares same-sex marriage legal lared same-sex marriage legal in all fifty US states.	32	40	same-sex	1	0	1
3XAOZ9UYRZSQOW6PCZBO2DPU4GN1Q1	#17-1 US Supreme Court declares same-sex marriage legal lared same-sex marriage legal in all fifty US states.	50	55	legal	1	0	1
3XAOZ9UYRZSQOW6PCZBO2DPU4GN1Q1	#17-1 US Supreme Court declares same-sex marriage legal lared same-sex marriage legal in all fifty US states.	50	62	legal  lared	0	2	2
3XAOZ9UYRZSQOW6PCZBO2DPU4GN1Q1	#17-1 US Supreme Court declares same-sex marriage legal lared same-sex marriage legal in all fifty US states.	56	61	lared	6	6	12
3XAOZ9UYRZSQOW6PCZBO2DPU4GN1Q1	#17-1 US Supreme Court declares same-sex marriage legal lared same-sex marriage legal in all fifty US states.	71	79	marriage	1	0	1
3XAOZ9UYRZSQOW6PCZBO2DPU4GN1Q1	#17-1 US Supreme Court declares same-sex marriage legal lared same-sex marriage legal in all fifty US states.	80	85	legal	1	0	1
3XAOZ9UYRZSQOW6PCZBO2DPU4GN1Q1	#17-2 More than 30 states already permitted gay marriage.	34	43	permitted	4	0	4
3XAOZ9UYRZSQOW6PCZBO2DPU4GN1Q1	#17-2 More than 30 states already permitted gay marriage.	44	47	gay	0	2	2
3XAOZ9UYRZSQOW6PCZBO2DPU4GN1Q1	#17-2 More than 30 states already permitted gay marriage.	44	56	gay marriage	1	1	2
3XAOZ9UYRZSQOW6PCZBO2DPU4GN1Q1	#17-3 The Supreme Court ruled by a five-to-four vote that bans on same-sex marriage were not constitutional.	58	62	bans	1	2	3
3XAOZ9UYRZSQOW6PCZBO2DPU4GN1Q1	#17-3 The Supreme Court ruled by a five-to-four vote that bans on same-sex marriage were not constitutional.	66	74	same-sex	1	0	1
3XAOZ9UYRZSQOW6PCZBO2DPU4GN1Q1	#17-3 The Supreme Court ruled by a five-to-four vote that bans on same-sex marriage were not constitutional.	89	107	not constitutional	0	1	1
3XAOZ9UYRZSQOW6PCZBO2DPU4GN1Q1	#17-3 The Supreme Court ruled by a five-to-four vote that bans on same-sex marriage were not constitutional.	93	107	constitutional	10	5	15
3XAOZ9UYRZSQOW6PCZBO2DPU4GN1Q1	#17-4 The majority decision was delivered by Justice Anthony Kennedy.	10	18	majority	3	0	3
3XAOZ9UYRZSQOW6PCZBO2DPU4GN1Q1	#17-4 The majority decision was delivered by Justice Anthony Kennedy.	10	27	majority decision	1	1	2
3XAOZ9UYRZSQOW6PCZBO2DPU4GN1Q1	#17-4 The majority decision was delivered by Justice Anthony Kennedy.	19	27	decision	1	0	1
3XAOZ9UYRZSQOW6PCZBO2DPU4GN1Q1	#17-4 The majority decision was delivered by Justice Anthony Kennedy.	32	41	delivered	0	1	1
3XAOZ9UYRZSQOW6PCZBO2DPU4GN1Q1	#17-4 The majority decision was delivered by Justice Anthony Kennedy.	53	68	Anthony Kennedy	0	1	1
3XAOZ9UYRZSQOW6PCZBO2DPU4GN1Q1	#17-5 Same-sex marriage was banned in more than a dozen states.	28	34	banned	3	0	3
3XAOZ9UYRZSQOW6PCZBO2DPU4GN1Q1	#17-5 Same-sex marriage was banned in more than a dozen states.	50	55	dozen	1	0	1
3XAOZ9UYRZSQOW6PCZBO2DPU4GN1Q1	#17-6 Justices Sotomayor, Ginsburg, Kagan, Breyer and Kennedy voted in favour while Justices Roberts, Alito, Scalia and Thomas voted against.	15	24	Sotomayor	0	1	1
3XAOZ9UYRZSQOW6PCZBO2DPU4GN1Q1	#17-6 Justices Sotomayor, Ginsburg, Kagan, Breyer and Kennedy voted in favour while Justices Roberts, Alito, Scalia and Thomas voted against.	26	34	Ginsburg	0	1	1
3XAOZ9UYRZSQOW6PCZBO2DPU4GN1Q1	#17-6 Justices Sotomayor, Ginsburg, Kagan, Breyer and Kennedy voted in favour while Justices Roberts, Alito, Scalia and Thomas voted against.	36	41	Kagan	0	1	1
3XAOZ9UYRZSQOW6PCZBO2DPU4GN1Q1	#17-6 Justices Sotomayor, Ginsburg, Kagan, Breyer and Kennedy voted in favour while Justices Roberts, Alito, Scalia and Thomas voted against.	43	49	Breyer	0	1	1
3XAOZ9UYRZSQOW6PCZBO2DPU4GN1Q1	#17-6 Justices Sotomayor, Ginsburg, Kagan, Breyer and Kennedy voted in favour while Justices Roberts, Alito, Scalia and Thomas voted against.	54	61	Kennedy	0	1	1
3XAOZ9UYRZSQOW6PCZBO2DPU4GN1Q1	#17-6 Justices Sotomayor, Ginsburg, Kagan, Breyer and Kennedy voted in favour while Justices Roberts, Alito, Scalia and Thomas voted against.	71	77	favour	1	0	1
3XAOZ9UYRZSQOW6PCZBO2DPU4GN1Q1	#17-6 Justices Sotomayor, Ginsburg, Kagan, Breyer and Kennedy voted in favour while Justices Roberts, Alito, Scalia and Thomas voted against.	102	107	Alito	0	1	1
3XAOZ9UYRZSQOW6PCZBO2DPU4GN1Q1	#17-6 Justices Sotomayor, Ginsburg, Kagan, Breyer and Kennedy voted in favour while Justices Roberts, Alito, Scalia and Thomas voted against.	109	115	Scalia	0	1	1
3XAOZ9UYRZSQOW6PCZBO2DPU4GN1Q1	#17-7 Kennedy's decision brought tears to the eyes of some lawyers in the courtroom.	16	24	decision	1	0	1
3XAOZ9UYRZSQOW6PCZBO2DPU4GN1Q1	#17-7 Kennedy's decision brought tears to the eyes of some lawyers in the courtroom.	25	32	brought	0	1	1
3XAOZ9UYRZSQOW6PCZBO2DPU4GN1Q1	#17-7 Kennedy's decision brought tears to the eyes of some lawyers in the courtroom.	59	66	lawyers	1	0	1
3XAOZ9UYRZSQOW6PCZBO2DPU4GN1Q1	#17-8 However, Justice Antonin Scalia in his dissenting opinion derided the majority decision: "The opinion is couched in a style that is as pretentious as its content is egotistic.	23	37	Antonin Scalia	1	1	2
3XAOZ9UYRZSQOW6PCZBO2DPU4GN1Q1	#17-8 However, Justice Antonin Scalia in his dissenting opinion derided the majority decision: "The opinion is couched in a style that is as pretentious as its content is egotistic.	45	55	dissenting	9	8	17
3XAOZ9UYRZSQOW6PCZBO2DPU4GN1Q1	#17-8 However, Justice Antonin Scalia in his dissenting opinion derided the majority decision: "The opinion is couched in a style that is as pretentious as its content is egotistic.	45	63	dissenting opinion	1	1	2
3XAOZ9UYRZSQOW6PCZBO2DPU4GN1Q1	#17-8 However, Justice Antonin Scalia in his dissenting opinion derided the majority decision: "The opinion is couched in a style that is as pretentious as its content is egotistic.	64	71	derided	6	10	16
3XAOZ9UYRZSQOW6PCZBO2DPU4GN1Q1	#17-8 However, Justice Antonin Scalia in his dissenting opinion derided the majority decision: "The opinion is couched in a style that is as pretentious as its content is egotistic.	76	84	majority	1	0	1
3XAOZ9UYRZSQOW6PCZBO2DPU4GN1Q1	#17-8 However, Justice Antonin Scalia in his dissenting opinion derided the majority decision: "The opinion is couched in a style that is as pretentious as its content is egotistic.	108	118	is couched	0	1	1
3XAOZ9UYRZSQOW6PCZBO2DPU4GN1Q1	#17-8 However, Justice Antonin Scalia in his dissenting opinion derided the majority decision: "The opinion is couched in a style that is as pretentious as its content is egotistic.	111	118	couched	4	8	12
3XAOZ9UYRZSQOW6PCZBO2DPU4GN1Q1	#17-8 However, Justice Antonin Scalia in his dissenting opinion derided the majority decision: "The opinion is couched in a style that is as pretentious as its content is egotistic.	141	152	pretentious	10	10	20
3XAOZ9UYRZSQOW6PCZBO2DPU4GN1Q1	#17-8 However, Justice Antonin Scalia in his dissenting opinion derided the majority decision: "The opinion is couched in a style that is as pretentious as its content is egotistic.	160	167	content	1	0	1
3XAOZ9UYRZSQOW6PCZBO2DPU4GN1Q1	#17-8 However, Justice Antonin Scalia in his dissenting opinion derided the majority decision: "The opinion is couched in a style that is as pretentious as its content is egotistic.	160	180	content is egotistic	1	0	1
3XAOZ9UYRZSQOW6PCZBO2DPU4GN1Q1	#17-8 However, Justice Antonin Scalia in his dissenting opinion derided the majority decision: "The opinion is couched in a style that is as pretentious as its content is egotistic.	171	180	egotistic	10	7	17
3B6F54KMR2D21CL2430TXD4VM481SQ	#18-6 Adnan began his hunger strike in protest of his administrative detention, which began last July, demanding Israel either release or charge him.	22	35	hunger strike	1	2	3
3B6F54KMR2D21CL2430TXD4VM481SQ	#18-6 Adnan began his hunger strike in protest of his administrative detention, which began last July, demanding Israel either release or charge him.	39	46	protest	1	1	2
3B6F54KMR2D21CL2430TXD4VM481SQ	#18-6 Adnan began his hunger strike in protest of his administrative detention, which began last July, demanding Israel either release or charge him.	54	68	administrative	4	0	4
3B6F54KMR2D21CL2430TXD4VM481SQ	#18-6 Adnan began his hunger strike in protest of his administrative detention, which began last July, demanding Israel either release or charge him.	54	78	administrative detention	5	2	7
3B6F54KMR2D21CL2430TXD4VM481SQ	#18-6 Adnan began his hunger strike in protest of his administrative detention, which began last July, demanding Israel either release or charge him.	69	78	detention	8	5	13
3B6F54KMR2D21CL2430TXD4VM481SQ	#18-6 Adnan began his hunger strike in protest of his administrative detention, which began last July, demanding Israel either release or charge him.	103	112	demanding	1	4	5
3B6F54KMR2D21CL2430TXD4VM481SQ	#18-6 Adnan began his hunger strike in protest of his administrative detention, which began last July, demanding Israel either release or charge him.	127	134	release	0	2	2
3B6F54KMR2D21CL2430TXD4VM481SQ	#18-6 Adnan began his hunger strike in protest of his administrative detention, which began last July, demanding Israel either release or charge him.	138	144	charge	0	2	2
3B6F54KMR2D21CL2430TXD4VM481SQ	#18-7 During his hunger strike, Adnan refused medical aid and relied only on water for sustenance, not taking any minerals or salts.	32	37	Adnan	0	1	1
3B6F54KMR2D21CL2430TXD4VM481SQ	#18-7 During his hunger strike, Adnan refused medical aid and relied only on water for sustenance, not taking any minerals or salts.	38	45	refused	2	1	3
3B6F54KMR2D21CL2430TXD4VM481SQ	#18-7 During his hunger strike, Adnan refused medical aid and relied only on water for sustenance, not taking any minerals or salts.	62	68	relied	2	5	7
3B6F54KMR2D21CL2430TXD4VM481SQ	#18-7 During his hunger strike, Adnan refused medical aid and relied only on water for sustenance, not taking any minerals or salts.	87	97	sustenance	10	9	19
3B6F54KMR2D21CL2430TXD4VM481SQ	#18-7 During his hunger strike, Adnan refused medical aid and relied only on water for sustenance, not taking any minerals or salts.	114	122	minerals	2	0	2
3B6F54KMR2D21CL2430TXD4VM481SQ	#18-8 Last week, the PIJ threatened to end its cease-fire with Israel, should Adnan die under Israeli custody.	25	35	threatened	9	2	11
3B6F54KMR2D21CL2430TXD4VM481SQ	#18-8 Last week, the PIJ threatened to end its cease-fire with Israel, should Adnan die under Israeli custody.	47	57	cease-fire	8	4	12
3B6F54KMR2D21CL2430TXD4VM481SQ	#18-8 Last week, the PIJ threatened to end its cease-fire with Israel, should Adnan die under Israeli custody.	102	109	custody	4	4	8
3B6F54KMR2D21CL2430TXD4VM481SQ	#18-9 Ahmed al-Aouri, a PIJ member, told al-Araby newspaper "the Islamic Jihad Movement — in which Khader Adnan is a leading member — will not be bound by any truce agreement if he comes to any harm."	65	78	Islamic Jihad	1	0	1
3B6F54KMR2D21CL2430TXD4VM481SQ	#18-9 Ahmed al-Aouri, a PIJ member, told al-Araby newspaper "the Islamic Jihad Movement — in which Khader Adnan is a leading member — will not be bound by any truce agreement if he comes to any harm."	99	111	Khader Adnan	0	1	1
3B6F54KMR2D21CL2430TXD4VM481SQ	#18-9 Ahmed al-Aouri, a PIJ member, told al-Araby newspaper "the Islamic Jihad Movement — in which Khader Adnan is a leading member — will not be bound by any truce agreement if he comes to any harm."	146	151	bound	1	2	3
3B6F54KMR2D21CL2430TXD4VM481SQ	#18-9 Ahmed al-Aouri, a PIJ member, told al-Araby newspaper "the Islamic Jihad Movement — in which Khader Adnan is a leading member — will not be bound by any truce agreement if he comes to any harm."	159	164	truce	5	8	13
3B6F54KMR2D21CL2430TXD4VM481SQ	#18-9 Ahmed al-Aouri, a PIJ member, told al-Araby newspaper "the Islamic Jihad Movement — in which Khader Adnan is a leading member — will not be bound by any truce agreement if he comes to any harm."	159	174	truce agreement	1	1	2
3B6F54KMR2D21CL2430TXD4VM481SQ	#18-9 Ahmed al-Aouri, a PIJ member, told al-Araby newspaper "the Islamic Jihad Movement — in which Khader Adnan is a leading member — will not be bound by any truce agreement if he comes to any harm."	194	198	harm	0	1	1
3B6F54KMR2D21CL2430TXD4VM481SQ	#18-10 The PIJ is a militaristic Palestinian Jihad movement.	20	32	militaristic	8	3	11
3B6F54KMR2D21CL2430TXD4VM481SQ	#18-10 The PIJ is a militaristic Palestinian Jihad movement.	20	59	militaristic Palestinian Jihad movement	1	0	1
3B6F54KMR2D21CL2430TXD4VM481SQ	#18-10 The PIJ is a militaristic Palestinian Jihad movement.	33	44	Palestinian	1	0	1
3B6F54KMR2D21CL2430TXD4VM481SQ	#18-10 The PIJ is a militaristic Palestinian Jihad movement.	33	50	Palestinian Jihad	1	0	1
3B6F54KMR2D21CL2430TXD4VM481SQ	#18-10 The PIJ is a militaristic Palestinian Jihad movement.	33	59	Palestinian Jihad movement	0	1	1
3B6F54KMR2D21CL2430TXD4VM481SQ	#18-10 The PIJ is a militaristic Palestinian Jihad movement.	51	59	movement	1	0	1
3B6F54KMR2D21CL2430TXD4VM481SQ	#18-11 Adnan, 37, is an active member of the PIJ in the West Bank, and has been its spokesperson there.	45	65	PIJ in the West Bank	0	1	1
3B6F54KMR2D21CL2430TXD4VM481SQ	#18-11 Adnan, 37, is an active member of the PIJ in the West Bank, and has been its spokesperson there.	84	96	spokesperson	7	4	11
3SX4X51T80AJX869T5CDO9NXT9BOA4	#42-19 Nick Bos: Me and a studymate were keeping a lot of animals during our studies, from beetles, to butterflies and mantids, to ants.	26	35	studymate	9	9	18
3SX4X51T80AJX869T5CDO9NXT9BOA4	#42-19 Nick Bos: Me and a studymate were keeping a lot of animals during our studies, from beetles, to butterflies and mantids, to ants.	41	48	keeping	1	0	1
3SX4X51T80AJX869T5CDO9NXT9BOA4	#42-19 Nick Bos: Me and a studymate were keeping a lot of animals during our studies, from beetles, to butterflies and mantids, to ants.	77	84	studies	1	0	1
3SX4X51T80AJX869T5CDO9NXT9BOA4	#42-19 Nick Bos: Me and a studymate were keeping a lot of animals during our studies, from beetles, to butterflies and mantids, to ants.	91	98	beetles	2	3	5
3SX4X51T80AJX869T5CDO9NXT9BOA4	#42-19 Nick Bos: Me and a studymate were keeping a lot of animals during our studies, from beetles, to butterflies and mantids, to ants.	103	114	butterflies	2	0	2
3SX4X51T80AJX869T5CDO9NXT9BOA4	#42-19 Nick Bos: Me and a studymate were keeping a lot of animals during our studies, from beetles, to butterflies and mantids, to ants.	119	126	mantids	10	6	16
3SX4X51T80AJX869T5CDO9NXT9BOA4	#42-20 We had the ants in an observation nest, and I could just look at them for hours, watching them go about.	29	40	observation	10	3	13
3SX4X51T80AJX869T5CDO9NXT9BOA4	#42-20 We had the ants in an observation nest, and I could just look at them for hours, watching them go about.	29	45	observation nest	2	1	3
3SX4X51T80AJX869T5CDO9NXT9BOA4	#42-20 We had the ants in an observation nest, and I could just look at them for hours, watching them go about.	41	45	nest	0	2	2
3SX4X51T80AJX869T5CDO9NXT9BOA4	#42-20 We had the ants in an observation nest, and I could just look at them for hours, watching them go about.	102	110	go about	1	0	1
3SX4X51T80AJX869T5CDO9NXT9BOA4	#42-21 This was in my third year of Biology study I think.	36	43	Biology	4	1	5
3SX4X51T80AJX869T5CDO9NXT9BOA4	#42-22 After a while I needed to start thinking about an internship for my M.Sc.	57	67	internship	10	10	20
3SX4X51T80AJX869T5CDO9NXT9BOA4	#42-22 After a while I needed to start thinking about an internship for my M.Sc.	75	79	M.Sc	2	0	2
3SX4X51T80AJX869T5CDO9NXT9BOA4	#42-23 studies, and decided to write a couple of professors.	20	27	decided	0	1	1
3SX4X51T80AJX869T5CDO9NXT9BOA4	#42-23 studies, and decided to write a couple of professors.	39	45	couple	0	1	1
3SX4X51T80AJX869T5CDO9NXT9BOA4	#42-23 studies, and decided to write a couple of professors.	49	59	professors	4	2	6
3SX4X51T80AJX869T5CDO9NXT9BOA4	#42-24 I ended up going to the Centre for Social Evolution at the University of Copenhagen where I did a project on learning in Ants under supervision of Prof. Patrizia d'Ettorre.	42	58	Social Evolution	1	2	3
3SX4X51T80AJX869T5CDO9NXT9BOA4	#42-24 I ended up going to the Centre for Social Evolution at the University of Copenhagen where I did a project on learning in Ants under supervision of Prof. Patrizia d'Ettorre.	49	58	Evolution	4	1	5
3SX4X51T80AJX869T5CDO9NXT9BOA4	#42-24 I ended up going to the Centre for Social Evolution at the University of Copenhagen where I did a project on learning in Ants under supervision of Prof. Patrizia d'Ettorre.	80	90	Copenhagen	1	1	2
3SX4X51T80AJX869T5CDO9NXT9BOA4	#42-24 I ended up going to the Centre for Social Evolution at the University of Copenhagen where I did a project on learning in Ants under supervision of Prof. Patrizia d'Ettorre.	105	112	project	1	1	2
3SX4X51T80AJX869T5CDO9NXT9BOA4	#42-24 I ended up going to the Centre for Social Evolution at the University of Copenhagen where I did a project on learning in Ants under supervision of Prof. Patrizia d'Ettorre.	139	150	supervision	7	5	12
3SX4X51T80AJX869T5CDO9NXT9BOA4	#42-24 I ended up going to the Centre for Social Evolution at the University of Copenhagen where I did a project on learning in Ants under supervision of Prof. Patrizia d'Ettorre.	160	177	Patrizia dEttorre	1	1	2
3SX4X51T80AJX869T5CDO9NXT9BOA4	#42-25 I liked it so much there I ended up doing a PhD and I've been working on social insects ever since.	34	42	ended up	0	1	1
3SX4X51T80AJX869T5CDO9NXT9BOA4	#42-25 I liked it so much there I ended up doing a PhD and I've been working on social insects ever since.	51	54	PhD	1	0	1
3SX4X51T80AJX869T5CDO9NXT9BOA4	#42-25 I liked it so much there I ended up doing a PhD and I've been working on social insects ever since.	80	86	social	1	0	1
3SX4X51T80AJX869T5CDO9NXT9BOA4	#42-25 I liked it so much there I ended up doing a PhD and I've been working on social insects ever since.	80	94	social insects	3	3	6
3SX4X51T80AJX869T5CDO9NXT9BOA4	#42-25 I liked it so much there I ended up doing a PhD and I've been working on social insects ever since.	87	94	insects	1	0	1
3E9ZFLPWOYTLXZ3Z6KRMOK29ILLIX7	#28-24 Conley was asked about his son, Nate, by KPRC's Robert Arnold.	48	53	KPRCs	0	1	1
3E9ZFLPWOYTLXZ3Z6KRMOK29ILLIX7	#28-24 Conley was asked about his son, Nate, by KPRC's Robert Arnold.	48	67	KPRCs Robert Arnold	1	0	1
3E9ZFLPWOYTLXZ3Z6KRMOK29ILLIX7	#28-26 I love Nate to death," Conley replied.	37	44	replied	1	0	1
3E9ZFLPWOYTLXZ3Z6KRMOK29ILLIX7	#28-27 "Nate didn't give me any respect because of what his mother was doing to me[...] She was cheating on me."	32	39	respect	2	3	5
3E9ZFLPWOYTLXZ3Z6KRMOK29ILLIX7	#28-27 "Nate didn't give me any respect because of what his mother was doing to me[...] She was cheating on me."	96	104	cheating	7	7	14
3E9ZFLPWOYTLXZ3Z6KRMOK29ILLIX7	#28-27 "Nate didn't give me any respect because of what his mother was doing to me[...] She was cheating on me."	96	110	cheating on me	0	1	1
3E9ZFLPWOYTLXZ3Z6KRMOK29ILLIX7	#28-28 Saying his lawyer had instructed him not to speak about the events of Saturday inside the home, Conley did have the following to say about the Jackson children: "They were growing up to be monsters, they were disrespectful, rude in school.	29	39	instructed	9	7	16
3E9ZFLPWOYTLXZ3Z6KRMOK29ILLIX7	#28-28 Saying his lawyer had instructed him not to speak about the events of Saturday inside the home, Conley did have the following to say about the Jackson children: "They were growing up to be monsters, they were disrespectful, rude in school.	67	73	events	0	1	1
3E9ZFLPWOYTLXZ3Z6KRMOK29ILLIX7	#28-28 Saying his lawyer had instructed him not to speak about the events of Saturday inside the home, Conley did have the following to say about the Jackson children: "They were growing up to be monsters, they were disrespectful, rude in school.	123	132	following	2	0	2
3E9ZFLPWOYTLXZ3Z6KRMOK29ILLIX7	#28-28 Saying his lawyer had instructed him not to speak about the events of Saturday inside the home, Conley did have the following to say about the Jackson children: "They were growing up to be monsters, they were disrespectful, rude in school.	150	157	Jackson	0	1	1
3E9ZFLPWOYTLXZ3Z6KRMOK29ILLIX7	#28-28 Saying his lawyer had instructed him not to speak about the events of Saturday inside the home, Conley did have the following to say about the Jackson children: "They were growing up to be monsters, they were disrespectful, rude in school.	179	189	growing up	0	1	1
3E9ZFLPWOYTLXZ3Z6KRMOK29ILLIX7	#28-28 Saying his lawyer had instructed him not to speak about the events of Saturday inside the home, Conley did have the following to say about the Jackson children: "They were growing up to be monsters, they were disrespectful, rude in school.	196	204	monsters	7	8	15
3E9ZFLPWOYTLXZ3Z6KRMOK29ILLIX7	#28-28 Saying his lawyer had instructed him not to speak about the events of Saturday inside the home, Conley did have the following to say about the Jackson children: "They were growing up to be monsters, they were disrespectful, rude in school.	216	229	disrespectful	10	7	17
3E9ZFLPWOYTLXZ3Z6KRMOK29ILLIX7	#28-28 Saying his lawyer had instructed him not to speak about the events of Saturday inside the home, Conley did have the following to say about the Jackson children: "They were growing up to be monsters, they were disrespectful, rude in school.	231	235	rude	5	6	11
3E9ZFLPWOYTLXZ3Z6KRMOK29ILLIX7	#28-28 Saying his lawyer had instructed him not to speak about the events of Saturday inside the home, Conley did have the following to say about the Jackson children: "They were growing up to be monsters, they were disrespectful, rude in school.	231	245	rude in school	0	1	1
3E9ZFLPWOYTLXZ3Z6KRMOK29ILLIX7	#28-30 I'm not even saying I killed them."	29	35	killed	0	2	2
3E9ZFLPWOYTLXZ3Z6KRMOK29ILLIX7	#28-31 Conley added, "God says in the Bible do not disrespect your mother and father or your days will be short, but I'm not saying that's what happened."	51	61	disrespect	7	6	13
3E9ZFLPWOYTLXZ3Z6KRMOK29ILLIX7	#28-31 Conley added, "God says in the Bible do not disrespect your mother and father or your days will be short, but I'm not saying that's what happened."	144	152	happened	3	1	4
3P6ENY9P79XOB93K1G90LYEFUV2HID	#40-3 The violence is thought to have started after a brief attempt by police to arrest protest leader Hardik Patel, 22 or 21.	10	18	violence	5	6	11
3P6ENY9P79XOB93K1G90LYEFUV2HID	#40-3 The violence is thought to have started after a brief attempt by police to arrest protest leader Hardik Patel, 22 or 21.	22	45	thought to have started	0	1	1
3P6ENY9P79XOB93K1G90LYEFUV2HID	#40-3 The violence is thought to have started after a brief attempt by police to arrest protest leader Hardik Patel, 22 or 21.	54	59	brief	3	2	5
3P6ENY9P79XOB93K1G90LYEFUV2HID	#40-3 The violence is thought to have started after a brief attempt by police to arrest protest leader Hardik Patel, 22 or 21.	54	67	brief attempt	0	1	1
3P6ENY9P79XOB93K1G90LYEFUV2HID	#40-3 The violence is thought to have started after a brief attempt by police to arrest protest leader Hardik Patel, 22 or 21.	60	67	attempt	1	1	2
3P6ENY9P79XOB93K1G90LYEFUV2HID	#40-3 The violence is thought to have started after a brief attempt by police to arrest protest leader Hardik Patel, 22 or 21.	81	87	arrest	1	0	1
3P6ENY9P79XOB93K1G90LYEFUV2HID	#40-3 The violence is thought to have started after a brief attempt by police to arrest protest leader Hardik Patel, 22 or 21.	88	95	protest	7	1	8
3P6ENY9P79XOB93K1G90LYEFUV2HID	#40-3 The violence is thought to have started after a brief attempt by police to arrest protest leader Hardik Patel, 22 or 21.	88	102	protest leader	0	2	2
3P6ENY9P79XOB93K1G90LYEFUV2HID	#40-3 The violence is thought to have started after a brief attempt by police to arrest protest leader Hardik Patel, 22 or 21.	103	109	Hardik	1	1	2
3P6ENY9P79XOB93K1G90LYEFUV2HID	#40-3 The violence is thought to have started after a brief attempt by police to arrest protest leader Hardik Patel, 22 or 21.	103	115	Hardik Patel	0	1	1
3P6ENY9P79XOB93K1G90LYEFUV2HID	#40-4 There have been weeks of protests by members of the Patel caste, with the most recent involving an estimated half a million people.	31	39	protests	2	1	3
3P6ENY9P79XOB93K1G90LYEFUV2HID	#40-4 There have been weeks of protests by members of the Patel caste, with the most recent involving an estimated half a million people.	58	69	Patel caste	1	2	3
3P6ENY9P79XOB93K1G90LYEFUV2HID	#40-4 There have been weeks of protests by members of the Patel caste, with the most recent involving an estimated half a million people.	64	69	caste	1	2	3
3P6ENY9P79XOB93K1G90LYEFUV2HID	#40-4 There have been weeks of protests by members of the Patel caste, with the most recent involving an estimated half a million people.	92	101	involving	0	1	1
3P6ENY9P79XOB93K1G90LYEFUV2HID	#40-4 There have been weeks of protests by members of the Patel caste, with the most recent involving an estimated half a million people.	102	114	an estimated	1	0	1
3P6ENY9P79XOB93K1G90LYEFUV2HID	#40-4 There have been weeks of protests by members of the Patel caste, with the most recent involving an estimated half a million people.	105	114	estimated	5	3	8
3P6ENY9P79XOB93K1G90LYEFUV2HID	#40-4 There have been weeks of protests by members of the Patel caste, with the most recent involving an estimated half a million people.	122	129	million	0	1	1
3P6ENY9P79XOB93K1G90LYEFUV2HID	#40-5 Ahmedabad, the largest city in the state, has seen the closure of public transport, internet access, schools, and businesses.	6	15	Ahmedabad	1	1	2
3P6ENY9P79XOB93K1G90LYEFUV2HID	#40-5 Ahmedabad, the largest city in the state, has seen the closure of public transport, internet access, schools, and businesses.	61	68	closure	4	3	7
3P6ENY9P79XOB93K1G90LYEFUV2HID	#40-5 Ahmedabad, the largest city in the state, has seen the closure of public transport, internet access, schools, and businesses.	79	88	transport	1	0	1
3P6ENY9P79XOB93K1G90LYEFUV2HID	#40-5 Ahmedabad, the largest city in the state, has seen the closure of public transport, internet access, schools, and businesses.	90	105	internet access	1	0	1
3P6ENY9P79XOB93K1G90LYEFUV2HID	#40-5 Ahmedabad, the largest city in the state, has seen the closure of public transport, internet access, schools, and businesses.	99	105	access	1	0	1
3P6ENY9P79XOB93K1G90LYEFUV2HID	#40-5 Ahmedabad, the largest city in the state, has seen the closure of public transport, internet access, schools, and businesses.	120	130	businesses	0	1	1
3P6ENY9P79XOB93K1G90LYEFUV2HID	#40-6 Ahmedabad is being patrolled by 400 military personnel.	6	15	Ahmedabad	1	1	2
3P6ENY9P79XOB93K1G90LYEFUV2HID	#40-6 Ahmedabad is being patrolled by 400 military personnel.	25	34	patrolled	3	9	12
3P6ENY9P79XOB93K1G90LYEFUV2HID	#40-6 Ahmedabad is being patrolled by 400 military personnel.	42	60	military personnel	1	0	1
3P6ENY9P79XOB93K1G90LYEFUV2HID	#40-6 Ahmedabad is being patrolled by 400 military personnel.	51	60	personnel	5	2	7
3P6ENY9P79XOB93K1G90LYEFUV2HID	#40-7 The national government has deployed several thousand paramilitary personnel to assist the state government.	10	29	national government	1	0	1
3P6ENY9P79XOB93K1G90LYEFUV2HID	#40-7 The national government has deployed several thousand paramilitary personnel to assist the state government.	30	42	has deployed	0	1	1
3P6ENY9P79XOB93K1G90LYEFUV2HID	#40-7 The national government has deployed several thousand paramilitary personnel to assist the state government.	34	42	deployed	7	7	14
3P6ENY9P79XOB93K1G90LYEFUV2HID	#40-7 The national government has deployed several thousand paramilitary personnel to assist the state government.	60	72	paramilitary	10	5	15
3P6ENY9P79XOB93K1G90LYEFUV2HID	#40-7 The national government has deployed several thousand paramilitary personnel to assist the state government.	60	82	paramilitary personnel	1	0	1
3P6ENY9P79XOB93K1G90LYEFUV2HID	#40-7 The national government has deployed several thousand paramilitary personnel to assist the state government.	86	92	assist	0	1	1
3P6ENY9P79XOB93K1G90LYEFUV2HID	#40-7 The national government has deployed several thousand paramilitary personnel to assist the state government.	103	113	government	1	0	1
3P6ENY9P79XOB93K1G90LYEFUV2HID	#40-8 The Patel caste, who form up to a fifth of the state population, are generally seen as being affluent businesspeople.	10	21	Patel caste	1	0	1
3P6ENY9P79XOB93K1G90LYEFUV2HID	#40-8 The Patel caste, who form up to a fifth of the state population, are generally seen as being affluent businesspeople.	16	21	caste	3	0	3
3P6ENY9P79XOB93K1G90LYEFUV2HID	#40-8 The Patel caste, who form up to a fifth of the state population, are generally seen as being affluent businesspeople.	99	107	affluent	10	6	16
3P6ENY9P79XOB93K1G90LYEFUV2HID	#40-8 The Patel caste, who form up to a fifth of the state population, are generally seen as being affluent businesspeople.	99	122	affluent businesspeople	2	2	4
3P6ENY9P79XOB93K1G90LYEFUV2HID	#40-8 The Patel caste, who form up to a fifth of the state population, are generally seen as being affluent businesspeople.	108	122	businesspeople	1	0	1
3P6ENY9P79XOB93K1G90LYEFUV2HID	#40-9 However, they want their community to be given the status of Other Backward Class, which would result in eligibility for reserved jobs.	31	40	community	0	2	2
3P6ENY9P79XOB93K1G90LYEFUV2HID	#40-9 However, they want their community to be given the status of Other Backward Class, which would result in eligibility for reserved jobs.	67	87	Other Backward Class	1	2	3
3P6ENY9P79XOB93K1G90LYEFUV2HID	#40-9 However, they want their community to be given the status of Other Backward Class, which would result in eligibility for reserved jobs.	73	87	Backward Class	0	1	1
3P6ENY9P79XOB93K1G90LYEFUV2HID	#40-9 However, they want their community to be given the status of Other Backward Class, which would result in eligibility for reserved jobs.	111	122	eligibility	10	8	18
3P6ENY9P79XOB93K1G90LYEFUV2HID	#40-9 However, they want their community to be given the status of Other Backward Class, which would result in eligibility for reserved jobs.	127	135	reserved	3	1	4
36MUZ9VAE63VJOWWJ10J9Y1PAA2EDS	#28-1 Eight people found slain inside Houston-area home Saturday night, police in Houston, Texas, United States, discovered eight people killed in a home.	25	30	slain	10	10	20
36MUZ9VAE63VJOWWJ10J9Y1PAA2EDS	#28-1 Eight people found slain inside Houston-area home Saturday night, police in Houston, Texas, United States, discovered eight people killed in a home.	113	123	discovered	6	4	10
36MUZ9VAE63VJOWWJ10J9Y1PAA2EDS	#28-2 Six of the victims were children.	17	24	victims	5	4	9
36MUZ9VAE63VJOWWJ10J9Y1PAA2EDS	#28-3 Around 21:00 local time, Harris County Sheriff's Office (HSCO) deputies arrived at the home on a welfare check.	45	53	Sheriffs	1	0	1
36MUZ9VAE63VJOWWJ10J9Y1PAA2EDS	#28-3 Around 21:00 local time, Harris County Sheriff's Office (HSCO) deputies arrived at the home on a welfare check.	69	77	deputies	6	4	10
36MUZ9VAE63VJOWWJ10J9Y1PAA2EDS	#28-3 Around 21:00 local time, Harris County Sheriff's Office (HSCO) deputies arrived at the home on a welfare check.	103	110	welfare	6	1	7
36MUZ9VAE63VJOWWJ10J9Y1PAA2EDS	#28-3 Around 21:00 local time, Harris County Sheriff's Office (HSCO) deputies arrived at the home on a welfare check.	103	116	welfare check	0	2	2
36MUZ9VAE63VJOWWJ10J9Y1PAA2EDS	#28-3 Around 21:00 local time, Harris County Sheriff's Office (HSCO) deputies arrived at the home on a welfare check.	111	116	check	1	0	1
36MUZ9VAE63VJOWWJ10J9Y1PAA2EDS	#28-4 After repeatedly trying to get someone to come to the door, officers forced their way into the house.	12	22	repeatedly	3	1	4
36MUZ9VAE63VJOWWJ10J9Y1PAA2EDS	#28-4 After repeatedly trying to get someone to come to the door, officers forced their way into the house.	66	74	officers	1	0	1
36MUZ9VAE63VJOWWJ10J9Y1PAA2EDS	#28-4 After repeatedly trying to get someone to come to the door, officers forced their way into the house.	75	91	forced their way	0	1	1
36MUZ9VAE63VJOWWJ10J9Y1PAA2EDS	#28-5 Here, police say, they were met by gunfire and a standoff ensued.	41	48	gunfire	1	0	1
36MUZ9VAE63VJOWWJ10J9Y1PAA2EDS	#28-5 Here, police say, they were met by gunfire and a standoff ensued.	55	63	standoff	8	7	15
36MUZ9VAE63VJOWWJ10J9Y1PAA2EDS	#28-5 Here, police say, they were met by gunfire and a standoff ensued.	55	70	standoff ensued	0	4	4
36MUZ9VAE63VJOWWJ10J9Y1PAA2EDS	#28-5 Here, police say, they were met by gunfire and a standoff ensued.	64	70	ensued	10	5	15
36MUZ9VAE63VJOWWJ10J9Y1PAA2EDS	#28-6 After upwards of an hour, with the house surrounded by special police units, the suspect was talked out of the house.	12	19	upwards	2	2	4
36MUZ9VAE63VJOWWJ10J9Y1PAA2EDS	#28-6 After upwards of an hour, with the house surrounded by special police units, the suspect was talked out of the house.	47	57	surrounded	3	2	5
36MUZ9VAE63VJOWWJ10J9Y1PAA2EDS	#28-6 After upwards of an hour, with the house surrounded by special police units, the suspect was talked out of the house.	76	81	units	1	0	1
36MUZ9VAE63VJOWWJ10J9Y1PAA2EDS	#28-6 After upwards of an hour, with the house surrounded by special police units, the suspect was talked out of the house.	87	94	suspect	2	4	6
36MUZ9VAE63VJOWWJ10J9Y1PAA2EDS	#28-7 David Conley, 49, was arrested by the HSCO and subsequently charged with the crimes.	28	36	arrested	1	0	1
36MUZ9VAE63VJOWWJ10J9Y1PAA2EDS	#28-7 David Conley, 49, was arrested by the HSCO and subsequently charged with the crimes.	44	48	HSCO	2	0	2
36MUZ9VAE63VJOWWJ10J9Y1PAA2EDS	#28-7 David Conley, 49, was arrested by the HSCO and subsequently charged with the crimes.	53	65	subsequently	10	7	17
36MUZ9VAE63VJOWWJ10J9Y1PAA2EDS	#28-8 Reportedly Conley had a lengthy history of violent behavior that landed him in prison multiple times.	6	16	Reportedly	1	2	3
36MUZ9VAE63VJOWWJ10J9Y1PAA2EDS	#28-8 Reportedly Conley had a lengthy history of violent behavior that landed him in prison multiple times.	30	37	lengthy	2	0	2
36MUZ9VAE63VJOWWJ10J9Y1PAA2EDS	#28-8 Reportedly Conley had a lengthy history of violent behavior that landed him in prison multiple times.	49	56	violent	4	3	7
36MUZ9VAE63VJOWWJ10J9Y1PAA2EDS	#28-8 Reportedly Conley had a lengthy history of violent behavior that landed him in prison multiple times.	49	65	violent behavior	0	3	3
36MUZ9VAE63VJOWWJ10J9Y1PAA2EDS	#28-8 Reportedly Conley had a lengthy history of violent behavior that landed him in prison multiple times.	57	65	behavior	3	0	3
36MUZ9VAE63VJOWWJ10J9Y1PAA2EDS	#28-8 Reportedly Conley had a lengthy history of violent behavior that landed him in prison multiple times.	71	77	landed	1	1	2
36MUZ9VAE63VJOWWJ10J9Y1PAA2EDS	#28-8 Reportedly Conley had a lengthy history of violent behavior that landed him in prison multiple times.	85	91	prison	0	1	1
36MUZ9VAE63VJOWWJ10J9Y1PAA2EDS	#28-8 Reportedly Conley had a lengthy history of violent behavior that landed him in prison multiple times.	92	100	multiple	1	1	2
31N9JPQXIPJGPAEBYWMSQ6AWGUWHNT	#5-11 His government stands accused by Human Rights Watch of not taking adequate measures to protect the nation's citizens.	10	20	government	2	0	2
31N9JPQXIPJGPAEBYWMSQ6AWGUWHNT	#5-11 His government stands accused by Human Rights Watch of not taking adequate measures to protect the nation's citizens.	21	27	stands	0	1	1
31N9JPQXIPJGPAEBYWMSQ6AWGUWHNT	#5-11 His government stands accused by Human Rights Watch of not taking adequate measures to protect the nation's citizens.	21	35	stands accused	1	1	2
31N9JPQXIPJGPAEBYWMSQ6AWGUWHNT	#5-11 His government stands accused by Human Rights Watch of not taking adequate measures to protect the nation's citizens.	28	35	accused	1	7	8
31N9JPQXIPJGPAEBYWMSQ6AWGUWHNT	#5-11 His government stands accused by Human Rights Watch of not taking adequate measures to protect the nation's citizens.	65	89	taking adequate measures	1	0	1
31N9JPQXIPJGPAEBYWMSQ6AWGUWHNT	#5-11 His government stands accused by Human Rights Watch of not taking adequate measures to protect the nation's citizens.	72	80	adequate	10	7	17
31N9JPQXIPJGPAEBYWMSQ6AWGUWHNT	#5-11 His government stands accused by Human Rights Watch of not taking adequate measures to protect the nation's citizens.	72	89	adequate measures	1	2	3
31N9JPQXIPJGPAEBYWMSQ6AWGUWHNT	#5-11 His government stands accused by Human Rights Watch of not taking adequate measures to protect the nation's citizens.	114	122	citizens	2	0	2
31N9JPQXIPJGPAEBYWMSQ6AWGUWHNT	#5-12 The government says the dead include five suicide bombers.	48	55	suicide	3	4	7
31N9JPQXIPJGPAEBYWMSQ6AWGUWHNT	#5-12 The government says the dead include five suicide bombers.	48	63	suicide bombers	2	1	3
31N9JPQXIPJGPAEBYWMSQ6AWGUWHNT	#5-12 The government says the dead include five suicide bombers.	56	63	bombers	2	1	3
31N9JPQXIPJGPAEBYWMSQ6AWGUWHNT	#5-13 Al-Qaeda in the Islamic Maghreb claimed a single bomber from affiliate group al-Mourabitoun conducted the attack.	6	37	Al-Qaeda in the Islamic Maghreb	2	0	2
31N9JPQXIPJGPAEBYWMSQ6AWGUWHNT	#5-13 Al-Qaeda in the Islamic Maghreb claimed a single bomber from affiliate group al-Mourabitoun conducted the attack.	30	37	Maghreb	0	1	1
31N9JPQXIPJGPAEBYWMSQ6AWGUWHNT	#5-13 Al-Qaeda in the Islamic Maghreb claimed a single bomber from affiliate group al-Mourabitoun conducted the attack.	38	45	claimed	1	1	2
31N9JPQXIPJGPAEBYWMSQ6AWGUWHNT	#5-13 Al-Qaeda in the Islamic Maghreb claimed a single bomber from affiliate group al-Mourabitoun conducted the attack.	67	76	affiliate	10	7	17
31N9JPQXIPJGPAEBYWMSQ6AWGUWHNT	#5-13 Al-Qaeda in the Islamic Maghreb claimed a single bomber from affiliate group al-Mourabitoun conducted the attack.	67	82	affiliate group	0	1	1
31N9JPQXIPJGPAEBYWMSQ6AWGUWHNT	#5-13 Al-Qaeda in the Islamic Maghreb claimed a single bomber from affiliate group al-Mourabitoun conducted the attack.	67	97	affiliate group al-Mourabitoun	1	0	1
31N9JPQXIPJGPAEBYWMSQ6AWGUWHNT	#5-13 Al-Qaeda in the Islamic Maghreb claimed a single bomber from affiliate group al-Mourabitoun conducted the attack.	83	97	al-Mourabitoun	2	0	2
31N9JPQXIPJGPAEBYWMSQ6AWGUWHNT	#5-13 Al-Qaeda in the Islamic Maghreb claimed a single bomber from affiliate group al-Mourabitoun conducted the attack.	98	107	conducted	4	2	6
31N9JPQXIPJGPAEBYWMSQ6AWGUWHNT	#6-1 Obama commutes whistleblower's sentence: Chelsea Manning to walk free in 120 days Yesterday, mere days before he is to leave office, U.S. President Barack Obama commuted the sentence of Army intelligence officer Chelsea Manning from 35 years to time served.	11	19	commutes	3	2	5
31N9JPQXIPJGPAEBYWMSQ6AWGUWHNT	#6-1 Obama commutes whistleblower's sentence: Chelsea Manning to walk free in 120 days Yesterday, mere days before he is to leave office, U.S. President Barack Obama commuted the sentence of Army intelligence officer Chelsea Manning from 35 years to time served.	20	33	whistleblower	1	1	2
31N9JPQXIPJGPAEBYWMSQ6AWGUWHNT	#6-1 Obama commutes whistleblower's sentence: Chelsea Manning to walk free in 120 days Yesterday, mere days before he is to leave office, U.S. President Barack Obama commuted the sentence of Army intelligence officer Chelsea Manning from 35 years to time served.	20	34	whistleblowers	9	6	15
31N9JPQXIPJGPAEBYWMSQ6AWGUWHNT	#6-1 Obama commutes whistleblower's sentence: Chelsea Manning to walk free in 120 days Yesterday, mere days before he is to leave office, U.S. President Barack Obama commuted the sentence of Army intelligence officer Chelsea Manning from 35 years to time served.	20	43	whistleblowers sentence	1	1	2
31N9JPQXIPJGPAEBYWMSQ6AWGUWHNT	#6-1 Obama commutes whistleblower's sentence: Chelsea Manning to walk free in 120 days Yesterday, mere days before he is to leave office, U.S. President Barack Obama commuted the sentence of Army intelligence officer Chelsea Manning from 35 years to time served.	54	61	Manning	0	1	1
31N9JPQXIPJGPAEBYWMSQ6AWGUWHNT	#6-1 Obama commutes whistleblower's sentence: Chelsea Manning to walk free in 120 days Yesterday, mere days before he is to leave office, U.S. President Barack Obama commuted the sentence of Army intelligence officer Chelsea Manning from 35 years to time served.	98	102	mere	1	2	3
31N9JPQXIPJGPAEBYWMSQ6AWGUWHNT	#6-1 Obama commutes whistleblower's sentence: Chelsea Manning to walk free in 120 days Yesterday, mere days before he is to leave office, U.S. President Barack Obama commuted the sentence of Army intelligence officer Chelsea Manning from 35 years to time served.	166	174	commuted	8	4	12
31N9JPQXIPJGPAEBYWMSQ6AWGUWHNT	#6-1 Obama commutes whistleblower's sentence: Chelsea Manning to walk free in 120 days Yesterday, mere days before he is to leave office, U.S. President Barack Obama commuted the sentence of Army intelligence officer Chelsea Manning from 35 years to time served.	179	187	sentence	0	1	1
31N9JPQXIPJGPAEBYWMSQ6AWGUWHNT	#6-1 Obama commutes whistleblower's sentence: Chelsea Manning to walk free in 120 days Yesterday, mere days before he is to leave office, U.S. President Barack Obama commuted the sentence of Army intelligence officer Chelsea Manning from 35 years to time served.	191	208	Army intelligence	0	1	1
31N9JPQXIPJGPAEBYWMSQ6AWGUWHNT	#6-1 Obama commutes whistleblower's sentence: Chelsea Manning to walk free in 120 days Yesterday, mere days before he is to leave office, U.S. President Barack Obama commuted the sentence of Army intelligence officer Chelsea Manning from 35 years to time served.	196	208	intelligence	2	0	2
31N9JPQXIPJGPAEBYWMSQ6AWGUWHNT	#6-1 Obama commutes whistleblower's sentence: Chelsea Manning to walk free in 120 days Yesterday, mere days before he is to leave office, U.S. President Barack Obama commuted the sentence of Army intelligence officer Chelsea Manning from 35 years to time served.	247	261	to time served	1	0	1
31N9JPQXIPJGPAEBYWMSQ6AWGUWHNT	#6-2 Manning, who in 2010 released thousands of classified documents to the public through WikiLeaks detailing abuses of the Iraq and Afghanistan wars, has already served almost seven years in prison and is now scheduled for release on May 17 of this year.	26	34	released	0	1	1
31N9JPQXIPJGPAEBYWMSQ6AWGUWHNT	#6-2 Manning, who in 2010 released thousands of classified documents to the public through WikiLeaks detailing abuses of the Iraq and Afghanistan wars, has already served almost seven years in prison and is now scheduled for release on May 17 of this year.	35	44	thousands	1	0	1
31N9JPQXIPJGPAEBYWMSQ6AWGUWHNT	#6-2 Manning, who in 2010 released thousands of classified documents to the public through WikiLeaks detailing abuses of the Iraq and Afghanistan wars, has already served almost seven years in prison and is now scheduled for release on May 17 of this year.	48	58	classified	2	2	4
31N9JPQXIPJGPAEBYWMSQ6AWGUWHNT	#6-2 Manning, who in 2010 released thousands of classified documents to the public through WikiLeaks detailing abuses of the Iraq and Afghanistan wars, has already served almost seven years in prison and is now scheduled for release on May 17 of this year.	48	68	classified documents	0	3	3
31N9JPQXIPJGPAEBYWMSQ6AWGUWHNT	#6-2 Manning, who in 2010 released thousands of classified documents to the public through WikiLeaks detailing abuses of the Iraq and Afghanistan wars, has already served almost seven years in prison and is now scheduled for release on May 17 of this year.	91	100	WikiLeaks	2	1	3
31N9JPQXIPJGPAEBYWMSQ6AWGUWHNT	#6-2 Manning, who in 2010 released thousands of classified documents to the public through WikiLeaks detailing abuses of the Iraq and Afghanistan wars, has already served almost seven years in prison and is now scheduled for release on May 17 of this year.	101	110	detailing	4	1	5
31N9JPQXIPJGPAEBYWMSQ6AWGUWHNT	#6-2 Manning, who in 2010 released thousands of classified documents to the public through WikiLeaks detailing abuses of the Iraq and Afghanistan wars, has already served almost seven years in prison and is now scheduled for release on May 17 of this year.	101	117	detailing abuses	0	1	1
31N9JPQXIPJGPAEBYWMSQ6AWGUWHNT	#6-2 Manning, who in 2010 released thousands of classified documents to the public through WikiLeaks detailing abuses of the Iraq and Afghanistan wars, has already served almost seven years in prison and is now scheduled for release on May 17 of this year.	111	117	abuses	1	4	5
31N9JPQXIPJGPAEBYWMSQ6AWGUWHNT	#6-2 Manning, who in 2010 released thousands of classified documents to the public through WikiLeaks detailing abuses of the Iraq and Afghanistan wars, has already served almost seven years in prison and is now scheduled for release on May 17 of this year.	134	145	Afghanistan	1	0	1
31N9JPQXIPJGPAEBYWMSQ6AWGUWHNT	#6-2 Manning, who in 2010 released thousands of classified documents to the public through WikiLeaks detailing abuses of the Iraq and Afghanistan wars, has already served almost seven years in prison and is now scheduled for release on May 17 of this year.	193	199	prison	1	1	2
31N9JPQXIPJGPAEBYWMSQ6AWGUWHNT	#6-2 Manning, who in 2010 released thousands of classified documents to the public through WikiLeaks detailing abuses of the Iraq and Afghanistan wars, has already served almost seven years in prison and is now scheduled for release on May 17 of this year.	211	220	scheduled	3	3	6
31N9JPQXIPJGPAEBYWMSQ6AWGUWHNT	#6-2 Manning, who in 2010 released thousands of classified documents to the public through WikiLeaks detailing abuses of the Iraq and Afghanistan wars, has already served almost seven years in prison and is now scheduled for release on May 17 of this year.	225	232	release	0	1	1
3H781YYV6TJ20DST5R0YE2JBDWQETB	#8-11 In the last two months, Bayern Munich has announced Polish striker Robert Lewandowski signed a contract extension until June 2021 and French winger Franck Ribéry signed a one-year contract extension with the club.	30	43	Bayern Munich	0	1	1
3H781YYV6TJ20DST5R0YE2JBDWQETB	#8-11 In the last two months, Bayern Munich has announced Polish striker Robert Lewandowski signed a contract extension until June 2021 and French winger Franck Ribéry signed a one-year contract extension with the club.	48	57	announced	6	2	8
3H781YYV6TJ20DST5R0YE2JBDWQETB	#8-11 In the last two months, Bayern Munich has announced Polish striker Robert Lewandowski signed a contract extension until June 2021 and French winger Franck Ribéry signed a one-year contract extension with the club.	58	72	Polish striker	1	0	1
3H781YYV6TJ20DST5R0YE2JBDWQETB	#8-11 In the last two months, Bayern Munich has announced Polish striker Robert Lewandowski signed a contract extension until June 2021 and French winger Franck Ribéry signed a one-year contract extension with the club.	65	72	striker	1	1	2
3H781YYV6TJ20DST5R0YE2JBDWQETB	#8-11 In the last two months, Bayern Munich has announced Polish striker Robert Lewandowski signed a contract extension until June 2021 and French winger Franck Ribéry signed a one-year contract extension with the club.	80	91	Lewandowski	1	1	2
3H781YYV6TJ20DST5R0YE2JBDWQETB	#8-11 In the last two months, Bayern Munich has announced Polish striker Robert Lewandowski signed a contract extension until June 2021 and French winger Franck Ribéry signed a one-year contract extension with the club.	101	109	contract	0	4	4
3H781YYV6TJ20DST5R0YE2JBDWQETB	#8-11 In the last two months, Bayern Munich has announced Polish striker Robert Lewandowski signed a contract extension until June 2021 and French winger Franck Ribéry signed a one-year contract extension with the club.	101	119	contract extension	1	0	1
3H781YYV6TJ20DST5R0YE2JBDWQETB	#8-11 In the last two months, Bayern Munich has announced Polish striker Robert Lewandowski signed a contract extension until June 2021 and French winger Franck Ribéry signed a one-year contract extension with the club.	110	119	extension	6	4	10
3H781YYV6TJ20DST5R0YE2JBDWQETB	#8-11 In the last two months, Bayern Munich has announced Polish striker Robert Lewandowski signed a contract extension until June 2021 and French winger Franck Ribéry signed a one-year contract extension with the club.	147	153	winger	2	2	4
3H781YYV6TJ20DST5R0YE2JBDWQETB	#8-11 In the last two months, Bayern Munich has announced Polish striker Robert Lewandowski signed a contract extension until June 2021 and French winger Franck Ribéry signed a one-year contract extension with the club.	147	160	winger Franck	0	1	1
3H781YYV6TJ20DST5R0YE2JBDWQETB	#8-11 In the last two months, Bayern Munich has announced Polish striker Robert Lewandowski signed a contract extension until June 2021 and French winger Franck Ribéry signed a one-year contract extension with the club.	154	167	Franck Ribéry	1	0	1
3H781YYV6TJ20DST5R0YE2JBDWQETB	#8-11 In the last two months, Bayern Munich has announced Polish striker Robert Lewandowski signed a contract extension until June 2021 and French winger Franck Ribéry signed a one-year contract extension with the club.	161	167	Ribéry	0	1	1
3H781YYV6TJ20DST5R0YE2JBDWQETB	#8-11 In the last two months, Bayern Munich has announced Polish striker Robert Lewandowski signed a contract extension until June 2021 and French winger Franck Ribéry signed a one-year contract extension with the club.	195	204	extension	3	1	4
3H781YYV6TJ20DST5R0YE2JBDWQETB	#9-1 At least 26 killed in another Brazil prison riot In the latest of a series of prison riots in prisons across Brazil, dozens of inmates, mostly rival gangs, were reported dead at the State Penitentiary of Alcaçuz, a state prison located in Natal, the capital of the Brazilian state, Rio Grande do Norte.	42	53	prison riot	1	0	1
3H781YYV6TJ20DST5R0YE2JBDWQETB	#9-1 At least 26 killed in another Brazil prison riot In the latest of a series of prison riots in prisons across Brazil, dozens of inmates, mostly rival gangs, were reported dead at the State Penitentiary of Alcaçuz, a state prison located in Natal, the capital of the Brazilian state, Rio Grande do Norte.	49	53	riot	2	3	5
3H781YYV6TJ20DST5R0YE2JBDWQETB	#9-1 At least 26 killed in another Brazil prison riot In the latest of a series of prison riots in prisons across Brazil, dozens of inmates, mostly rival gangs, were reported dead at the State Penitentiary of Alcaçuz, a state prison located in Natal, the capital of the Brazilian state, Rio Grande do Norte.	73	79	series	1	0	1
3H781YYV6TJ20DST5R0YE2JBDWQETB	#9-1 At least 26 killed in another Brazil prison riot In the latest of a series of prison riots in prisons across Brazil, dozens of inmates, mostly rival gangs, were reported dead at the State Penitentiary of Alcaçuz, a state prison located in Natal, the capital of the Brazilian state, Rio Grande do Norte.	83	89	prison	1	0	1
3H781YYV6TJ20DST5R0YE2JBDWQETB	#9-1 At least 26 killed in another Brazil prison riot In the latest of a series of prison riots in prisons across Brazil, dozens of inmates, mostly rival gangs, were reported dead at the State Penitentiary of Alcaçuz, a state prison located in Natal, the capital of the Brazilian state, Rio Grande do Norte.	83	95	prison riots	0	1	1
3H781YYV6TJ20DST5R0YE2JBDWQETB	#9-1 At least 26 killed in another Brazil prison riot In the latest of a series of prison riots in prisons across Brazil, dozens of inmates, mostly rival gangs, were reported dead at the State Penitentiary of Alcaçuz, a state prison located in Natal, the capital of the Brazilian state, Rio Grande do Norte.	90	95	riots	1	3	4
3H781YYV6TJ20DST5R0YE2JBDWQETB	#9-1 At least 26 killed in another Brazil prison riot In the latest of a series of prison riots in prisons across Brazil, dozens of inmates, mostly rival gangs, were reported dead at the State Penitentiary of Alcaçuz, a state prison located in Natal, the capital of the Brazilian state, Rio Grande do Norte.	99	106	prisons	0	1	1
3H781YYV6TJ20DST5R0YE2JBDWQETB	#9-1 At least 26 killed in another Brazil prison riot In the latest of a series of prison riots in prisons across Brazil, dozens of inmates, mostly rival gangs, were reported dead at the State Penitentiary of Alcaçuz, a state prison located in Natal, the capital of the Brazilian state, Rio Grande do Norte.	122	128	dozens	1	0	1
3H781YYV6TJ20DST5R0YE2JBDWQETB	#9-1 At least 26 killed in another Brazil prison riot In the latest of a series of prison riots in prisons across Brazil, dozens of inmates, mostly rival gangs, were reported dead at the State Penitentiary of Alcaçuz, a state prison located in Natal, the capital of the Brazilian state, Rio Grande do Norte.	132	139	inmates	2	9	11
3H781YYV6TJ20DST5R0YE2JBDWQETB	#9-1 At least 26 killed in another Brazil prison riot In the latest of a series of prison riots in prisons across Brazil, dozens of inmates, mostly rival gangs, were reported dead at the State Penitentiary of Alcaçuz, a state prison located in Natal, the capital of the Brazilian state, Rio Grande do Norte.	141	159	mostly rival gangs	1	0	1
3H781YYV6TJ20DST5R0YE2JBDWQETB	#9-1 At least 26 killed in another Brazil prison riot In the latest of a series of prison riots in prisons across Brazil, dozens of inmates, mostly rival gangs, were reported dead at the State Penitentiary of Alcaçuz, a state prison located in Natal, the capital of the Brazilian state, Rio Grande do Norte.	148	153	rival	3	2	5
3H781YYV6TJ20DST5R0YE2JBDWQETB	#9-1 At least 26 killed in another Brazil prison riot In the latest of a series of prison riots in prisons across Brazil, dozens of inmates, mostly rival gangs, were reported dead at the State Penitentiary of Alcaçuz, a state prison located in Natal, the capital of the Brazilian state, Rio Grande do Norte.	148	159	rival gangs	0	1	1
3H781YYV6TJ20DST5R0YE2JBDWQETB	#9-1 At least 26 killed in another Brazil prison riot In the latest of a series of prison riots in prisons across Brazil, dozens of inmates, mostly rival gangs, were reported dead at the State Penitentiary of Alcaçuz, a state prison located in Natal, the capital of the Brazilian state, Rio Grande do Norte.	154	159	gangs	0	1	1
3H781YYV6TJ20DST5R0YE2JBDWQETB	#9-1 At least 26 killed in another Brazil prison riot In the latest of a series of prison riots in prisons across Brazil, dozens of inmates, mostly rival gangs, were reported dead at the State Penitentiary of Alcaçuz, a state prison located in Natal, the capital of the Brazilian state, Rio Grande do Norte.	187	205	State Penitentiary	1	0	1
3H781YYV6TJ20DST5R0YE2JBDWQETB	#9-1 At least 26 killed in another Brazil prison riot In the latest of a series of prison riots in prisons across Brazil, dozens of inmates, mostly rival gangs, were reported dead at the State Penitentiary of Alcaçuz, a state prison located in Natal, the capital of the Brazilian state, Rio Grande do Norte.	193	205	Penitentiary	6	1	7
3H781YYV6TJ20DST5R0YE2JBDWQETB	#9-1 At least 26 killed in another Brazil prison riot In the latest of a series of prison riots in prisons across Brazil, dozens of inmates, mostly rival gangs, were reported dead at the State Penitentiary of Alcaçuz, a state prison located in Natal, the capital of the Brazilian state, Rio Grande do Norte.	209	216	Alcaçuz	3	1	4
3H781YYV6TJ20DST5R0YE2JBDWQETB	#9-1 At least 26 killed in another Brazil prison riot In the latest of a series of prison riots in prisons across Brazil, dozens of inmates, mostly rival gangs, were reported dead at the State Penitentiary of Alcaçuz, a state prison located in Natal, the capital of the Brazilian state, Rio Grande do Norte.	255	262	capital	1	1	2
3H781YYV6TJ20DST5R0YE2JBDWQETB	#9-1 At least 26 killed in another Brazil prison riot In the latest of a series of prison riots in prisons across Brazil, dozens of inmates, mostly rival gangs, were reported dead at the State Penitentiary of Alcaçuz, a state prison located in Natal, the capital of the Brazilian state, Rio Grande do Norte.	270	279	Brazilian	1	0	1
3H781YYV6TJ20DST5R0YE2JBDWQETB	#9-1 At least 26 killed in another Brazil prison riot In the latest of a series of prison riots in prisons across Brazil, dozens of inmates, mostly rival gangs, were reported dead at the State Penitentiary of Alcaçuz, a state prison located in Natal, the capital of the Brazilian state, Rio Grande do Norte.	301	306	Norte	1	0	1
3H781YYV6TJ20DST5R0YE2JBDWQETB	#9-2 Reports vary but, as of Sunday, the death toll may have reached 26.	13	17	vary	1	0	1
3H781YYV6TJ20DST5R0YE2JBDWQETB	#9-2 Reports vary but, as of Sunday, the death toll may have reached 26.	41	51	death toll	1	3	4
3H781YYV6TJ20DST5R0YE2JBDWQETB	#9-2 Reports vary but, as of Sunday, the death toll may have reached 26.	47	51	toll	0	3	3
3H781YYV6TJ20DST5R0YE2JBDWQETB	#9-3 According to the BBC, this figure is triple the initial reports.	5	14	According	0	1	1
3H781YYV6TJ20DST5R0YE2JBDWQETB	#9-3 According to the BBC, this figure is triple the initial reports.	42	48	triple	2	2	4
3H781YYV6TJ20DST5R0YE2JBDWQETB	#9-3 According to the BBC, this figure is triple the initial reports.	53	60	initial	3	0	3
3H781YYV6TJ20DST5R0YE2JBDWQETB	#9-3 According to the BBC, this figure is triple the initial reports.	53	68	initial reports	1	1	2
3H781YYV6TJ20DST5R0YE2JBDWQETB	#9-4 Prison authorities said that some victims were decapitated.	5	11	Prison	1	0	1
3H781YYV6TJ20DST5R0YE2JBDWQETB	#9-4 Prison authorities said that some victims were decapitated.	12	23	authorities	7	1	8
3H781YYV6TJ20DST5R0YE2JBDWQETB	#9-4 Prison authorities said that some victims were decapitated.	39	46	victims	3	2	5
3H781YYV6TJ20DST5R0YE2JBDWQETB	#9-4 Prison authorities said that some victims were decapitated.	52	63	decapitated	10	9	19
3H781YYV6TJ20DST5R0YE2JBDWQETB	#9-5 Prison coordinator Zemilton Silva witnessed this happen to three men, and forensic report that there have been more.	12	23	coordinator	10	0	10
3H781YYV6TJ20DST5R0YE2JBDWQETB	#9-5 Prison coordinator Zemilton Silva witnessed this happen to three men, and forensic report that there have been more.	24	32	Zemilton	1	2	3
3H781YYV6TJ20DST5R0YE2JBDWQETB	#9-5 Prison coordinator Zemilton Silva witnessed this happen to three men, and forensic report that there have been more.	39	48	witnessed	4	3	7
3H781YYV6TJ20DST5R0YE2JBDWQETB	#9-5 Prison coordinator Zemilton Silva witnessed this happen to three men, and forensic report that there have been more.	79	87	forensic	10	4	14
3H781YYV6TJ20DST5R0YE2JBDWQETB	#9-5 Prison coordinator Zemilton Silva witnessed this happen to three men, and forensic report that there have been more.	79	94	forensic report	0	1	1
