33P2GD6NRNTFH4T81JUCYETSN6ZHKB	She performed in the same production at the Royal Opera House , Covent Garden , in 1962 .	4	13	performed	0	4	4
33P2GD6NRNTFH4T81JUCYETSN6ZHKB	She performed in the same production at the Royal Opera House , Covent Garden , in 1962 .	26	36	production	2	2	4
33P2GD6NRNTFH4T81JUCYETSN6ZHKB	She performed in the same production at the Royal Opera House , Covent Garden , in 1962 .	44	61	Royal Opera House	0	1	1
33P2GD6NRNTFH4T81JUCYETSN6ZHKB	She performed in the same production at the Royal Opera House , Covent Garden , in 1962 .	50	55	Opera	0	1	1
33P2GD6NRNTFH4T81JUCYETSN6ZHKB	Bradamante , again searching for her lover , arrives on Alcina 's island with Ruggiero 's former tutor , Melisso .	0	10	Bradamante	2	1	3
33P2GD6NRNTFH4T81JUCYETSN6ZHKB	Bradamante , again searching for her lover , arrives on Alcina 's island with Ruggiero 's former tutor , Melisso .	66	72	island	0	1	1
33P2GD6NRNTFH4T81JUCYETSN6ZHKB	Bradamante , again searching for her lover , arrives on Alcina 's island with Ruggiero 's former tutor , Melisso .	78	86	Ruggiero	2	0	2
33P2GD6NRNTFH4T81JUCYETSN6ZHKB	Bradamante , again searching for her lover , arrives on Alcina 's island with Ruggiero 's former tutor , Melisso .	90	96	former	0	1	1
33P2GD6NRNTFH4T81JUCYETSN6ZHKB	Bradamante , again searching for her lover , arrives on Alcina 's island with Ruggiero 's former tutor , Melisso .	90	102	former tutor	1	1	2
33P2GD6NRNTFH4T81JUCYETSN6ZHKB	Bradamante , again searching for her lover , arrives on Alcina 's island with Ruggiero 's former tutor , Melisso .	97	102	tutor	2	5	7
33P2GD6NRNTFH4T81JUCYETSN6ZHKB	It is at this point that the audience realizes that Alcina genuinely loves Ruggiero ; from now until the end of the opera , she is depicted sympathetically .	29	37	audience	3	6	9
33P2GD6NRNTFH4T81JUCYETSN6ZHKB	It is at this point that the audience realizes that Alcina genuinely loves Ruggiero ; from now until the end of the opera , she is depicted sympathetically .	38	46	realizes	1	3	4
33P2GD6NRNTFH4T81JUCYETSN6ZHKB	It is at this point that the audience realizes that Alcina genuinely loves Ruggiero ; from now until the end of the opera , she is depicted sympathetically .	59	68	genuinely	5	7	12
33P2GD6NRNTFH4T81JUCYETSN6ZHKB	It is at this point that the audience realizes that Alcina genuinely loves Ruggiero ; from now until the end of the opera , she is depicted sympathetically .	131	139	depicted	5	8	13
33P2GD6NRNTFH4T81JUCYETSN6ZHKB	It is at this point that the audience realizes that Alcina genuinely loves Ruggiero ; from now until the end of the opera , she is depicted sympathetically .	131	155	depicted sympathetically	6	4	10
33P2GD6NRNTFH4T81JUCYETSN6ZHKB	It is at this point that the audience realizes that Alcina genuinely loves Ruggiero ; from now until the end of the opera , she is depicted sympathetically .	140	155	sympathetically	7	6	13
33P2GD6NRNTFH4T81JUCYETSN6ZHKB	Bradamante and Ruggiero decide that they need to destroy the source of Alcina 's magic , usually represented as an urn .	97	108	represented	3	3	6
33P2GD6NRNTFH4T81JUCYETSN6ZHKB	Bradamante and Ruggiero decide that they need to destroy the source of Alcina 's magic , usually represented as an urn .	115	118	urn	6	7	13
33P2GD6NRNTFH4T81JUCYETSN6ZHKB	The Festival was founded in 1948 by the composer Benjamin Britten , the singer Peter Pears and the librettist Eric Crozier .	17	24	founded	2	1	3
33P2GD6NRNTFH4T81JUCYETSN6ZHKB	The Festival was founded in 1948 by the composer Benjamin Britten , the singer Peter Pears and the librettist Eric Crozier .	40	48	composer	2	2	4
33P2GD6NRNTFH4T81JUCYETSN6ZHKB	The Festival was founded in 1948 by the composer Benjamin Britten , the singer Peter Pears and the librettist Eric Crozier .	99	109	librettist	9	10	19
33P2GD6NRNTFH4T81JUCYETSN6ZHKB	The original intention was to provide a home for their opera company , the English Opera Group , but the vision was soon widened to include readings of poetry , literature , drama , lectures and exhibitions of art .	13	22	intention	5	7	12
33P2GD6NRNTFH4T81JUCYETSN6ZHKB	The original intention was to provide a home for their opera company , the English Opera Group , but the vision was soon widened to include readings of poetry , literature , drama , lectures and exhibitions of art .	30	37	provide	0	1	1
33P2GD6NRNTFH4T81JUCYETSN6ZHKB	The original intention was to provide a home for their opera company , the English Opera Group , but the vision was soon widened to include readings of poetry , literature , drama , lectures and exhibitions of art .	55	60	opera	1	0	1
33P2GD6NRNTFH4T81JUCYETSN6ZHKB	The original intention was to provide a home for their opera company , the English Opera Group , but the vision was soon widened to include readings of poetry , literature , drama , lectures and exhibitions of art .	105	111	vision	2	1	3
33P2GD6NRNTFH4T81JUCYETSN6ZHKB	The original intention was to provide a home for their opera company , the English Opera Group , but the vision was soon widened to include readings of poetry , literature , drama , lectures and exhibitions of art .	121	128	widened	2	4	6
33P2GD6NRNTFH4T81JUCYETSN6ZHKB	The original intention was to provide a home for their opera company , the English Opera Group , but the vision was soon widened to include readings of poetry , literature , drama , lectures and exhibitions of art .	152	158	poetry	1	0	1
33P2GD6NRNTFH4T81JUCYETSN6ZHKB	The original intention was to provide a home for their opera company , the English Opera Group , but the vision was soon widened to include readings of poetry , literature , drama , lectures and exhibitions of art .	182	190	lectures	2	0	2
33P2GD6NRNTFH4T81JUCYETSN6ZHKB	The original intention was to provide a home for their opera company , the English Opera Group , but the vision was soon widened to include readings of poetry , literature , drama , lectures and exhibitions of art .	195	206	exhibitions	8	4	12
3KVQ0UJWPXMUWB3UPVC6XSKX54H5WE	The laws of thermodynamics state that absolute zero can not be reached using only thermodynamic means .	12	26	thermodynamics	10	10	20
3KVQ0UJWPXMUWB3UPVC6XSKX54H5WE	The laws of thermodynamics state that absolute zero can not be reached using only thermodynamic means .	38	46	absolute	5	2	7
3KVQ0UJWPXMUWB3UPVC6XSKX54H5WE	The laws of thermodynamics state that absolute zero can not be reached using only thermodynamic means .	38	51	absolute zero	2	1	3
3KVQ0UJWPXMUWB3UPVC6XSKX54H5WE	The laws of thermodynamics state that absolute zero can not be reached using only thermodynamic means .	63	70	reached	0	1	1
3KVQ0UJWPXMUWB3UPVC6XSKX54H5WE	The laws of thermodynamics state that absolute zero can not be reached using only thermodynamic means .	82	95	thermodynamic	3	2	5
3KVQ0UJWPXMUWB3UPVC6XSKX54H5WE	The laws of thermodynamics state that absolute zero can not be reached using only thermodynamic means .	82	101	thermodynamic means	0	1	1
3KVQ0UJWPXMUWB3UPVC6XSKX54H5WE	The laws of thermodynamics state that absolute zero can not be reached using only thermodynamic means .	96	101	means	1	2	3
3KVQ0UJWPXMUWB3UPVC6XSKX54H5WE	The zero point of any thermodynamic temperature scale , such as Kelvin or Rankine , is set at absolute zero .	4	14	zero point	1	0	1
3KVQ0UJWPXMUWB3UPVC6XSKX54H5WE	The zero point of any thermodynamic temperature scale , such as Kelvin or Rankine , is set at absolute zero .	22	35	thermodynamic	2	2	4
3KVQ0UJWPXMUWB3UPVC6XSKX54H5WE	The zero point of any thermodynamic temperature scale , such as Kelvin or Rankine , is set at absolute zero .	36	47	temperature	2	0	2
3KVQ0UJWPXMUWB3UPVC6XSKX54H5WE	The zero point of any thermodynamic temperature scale , such as Kelvin or Rankine , is set at absolute zero .	36	53	temperature scale	1	0	1
3KVQ0UJWPXMUWB3UPVC6XSKX54H5WE	The zero point of any thermodynamic temperature scale , such as Kelvin or Rankine , is set at absolute zero .	48	53	scale	1	1	2
3KVQ0UJWPXMUWB3UPVC6XSKX54H5WE	The zero point of any thermodynamic temperature scale , such as Kelvin or Rankine , is set at absolute zero .	64	70	Kelvin	2	0	2
3KVQ0UJWPXMUWB3UPVC6XSKX54H5WE	The zero point of any thermodynamic temperature scale , such as Kelvin or Rankine , is set at absolute zero .	74	81	Rankine	2	0	2
3KVQ0UJWPXMUWB3UPVC6XSKX54H5WE	The zero point of any thermodynamic temperature scale , such as Kelvin or Rankine , is set at absolute zero .	94	102	absolute	0	1	1
3KVQ0UJWPXMUWB3UPVC6XSKX54H5WE	The zero point of any thermodynamic temperature scale , such as Kelvin or Rankine , is set at absolute zero .	94	107	absolute zero	1	0	1
3KVQ0UJWPXMUWB3UPVC6XSKX54H5WE	The Academy Award for Best Picture is one of the Academy Awards of Merit presented annually by the Academy of Motion Picture Arts and Sciences ( AMPAS ) to artists working in the motion picture industry .	4	11	Academy	0	1	1
3KVQ0UJWPXMUWB3UPVC6XSKX54H5WE	The Academy Award for Best Picture is one of the Academy Awards of Merit presented annually by the Academy of Motion Picture Arts and Sciences ( AMPAS ) to artists working in the motion picture industry .	12	17	Award	0	2	2
3KVQ0UJWPXMUWB3UPVC6XSKX54H5WE	The Academy Award for Best Picture is one of the Academy Awards of Merit presented annually by the Academy of Motion Picture Arts and Sciences ( AMPAS ) to artists working in the motion picture industry .	67	72	Merit	1	3	4
3KVQ0UJWPXMUWB3UPVC6XSKX54H5WE	The Academy Award for Best Picture is one of the Academy Awards of Merit presented annually by the Academy of Motion Picture Arts and Sciences ( AMPAS ) to artists working in the motion picture industry .	83	91	annually	2	2	4
3KVQ0UJWPXMUWB3UPVC6XSKX54H5WE	The Academy Award for Best Picture is one of the Academy Awards of Merit presented annually by the Academy of Motion Picture Arts and Sciences ( AMPAS ) to artists working in the motion picture industry .	110	116	Motion	0	2	2
3KVQ0UJWPXMUWB3UPVC6XSKX54H5WE	The Academy Award for Best Picture is one of the Academy Awards of Merit presented annually by the Academy of Motion Picture Arts and Sciences ( AMPAS ) to artists working in the motion picture industry .	110	124	Motion Picture	0	1	1
3KVQ0UJWPXMUWB3UPVC6XSKX54H5WE	The Academy Award for Best Picture is one of the Academy Awards of Merit presented annually by the Academy of Motion Picture Arts and Sciences ( AMPAS ) to artists working in the motion picture industry .	110	129	Motion Picture Arts	1	0	1
3KVQ0UJWPXMUWB3UPVC6XSKX54H5WE	The Academy Award for Best Picture is one of the Academy Awards of Merit presented annually by the Academy of Motion Picture Arts and Sciences ( AMPAS ) to artists working in the motion picture industry .	134	142	Sciences	1	0	1
3KVQ0UJWPXMUWB3UPVC6XSKX54H5WE	The Academy Award for Best Picture is one of the Academy Awards of Merit presented annually by the Academy of Motion Picture Arts and Sciences ( AMPAS ) to artists working in the motion picture industry .	179	193	motion picture	1	1	2
3KVQ0UJWPXMUWB3UPVC6XSKX54H5WE	The Academy Award for Best Picture is one of the Academy Awards of Merit presented annually by the Academy of Motion Picture Arts and Sciences ( AMPAS ) to artists working in the motion picture industry .	179	202	motion picture industry	1	1	2
3KVQ0UJWPXMUWB3UPVC6XSKX54H5WE	The Academy Award for Best Picture is one of the Academy Awards of Merit presented annually by the Academy of Motion Picture Arts and Sciences ( AMPAS ) to artists working in the motion picture industry .	194	202	industry	1	0	1
3KVQ0UJWPXMUWB3UPVC6XSKX54H5WE	The 2007 enlargement of the European Union saw Bulgaria and Romania join the European Union ( EU ) on 1 January 2007 .	9	20	enlargement	8	10	18
3KVQ0UJWPXMUWB3UPVC6XSKX54H5WE	Romania was the first country of post-communist Europe to have official relations with the European Community .	33	47	post-communist	7	4	11
3KVQ0UJWPXMUWB3UPVC6XSKX54H5WE	Romania signed its Europe Agreement in 1993 , and submitted its official application for membership in the EU in 1995 , the third of the post-communist European countries to do so after Hungary and Poland .	8	14	signed	1	1	2
3KVQ0UJWPXMUWB3UPVC6XSKX54H5WE	Romania signed its Europe Agreement in 1993 , and submitted its official application for membership in the EU in 1995 , the third of the post-communist European countries to do so after Hungary and Poland .	19	25	Europe	0	1	1
3KVQ0UJWPXMUWB3UPVC6XSKX54H5WE	Romania signed its Europe Agreement in 1993 , and submitted its official application for membership in the EU in 1995 , the third of the post-communist European countries to do so after Hungary and Poland .	26	35	Agreement	1	0	1
3KVQ0UJWPXMUWB3UPVC6XSKX54H5WE	Romania signed its Europe Agreement in 1993 , and submitted its official application for membership in the EU in 1995 , the third of the post-communist European countries to do so after Hungary and Poland .	50	59	submitted	2	5	7
3KVQ0UJWPXMUWB3UPVC6XSKX54H5WE	Romania signed its Europe Agreement in 1993 , and submitted its official application for membership in the EU in 1995 , the third of the post-communist European countries to do so after Hungary and Poland .	64	99	official application for membership	1	0	1
3KVQ0UJWPXMUWB3UPVC6XSKX54H5WE	Romania signed its Europe Agreement in 1993 , and submitted its official application for membership in the EU in 1995 , the third of the post-communist European countries to do so after Hungary and Poland .	73	84	application	1	1	2
3KVQ0UJWPXMUWB3UPVC6XSKX54H5WE	Romania signed its Europe Agreement in 1993 , and submitted its official application for membership in the EU in 1995 , the third of the post-communist European countries to do so after Hungary and Poland .	89	99	membership	0	2	2
3KVQ0UJWPXMUWB3UPVC6XSKX54H5WE	Romania signed its Europe Agreement in 1993 , and submitted its official application for membership in the EU in 1995 , the third of the post-communist European countries to do so after Hungary and Poland .	137	151	post-communist	7	0	7
3KVQ0UJWPXMUWB3UPVC6XSKX54H5WE	Romania signed its Europe Agreement in 1993 , and submitted its official application for membership in the EU in 1995 , the third of the post-communist European countries to do so after Hungary and Poland .	186	204	Hungary and Poland	0	1	1
3LOJFQ4BOXGY5OO6FNBM7TEUVE6KD5	Tallari had an outstanding season in Manchester , finishing as the EIHL 's second highest goal scorer , managing 55 goals and 38 assists in 59 games .	0	7	Tallari	0	1	1
3LOJFQ4BOXGY5OO6FNBM7TEUVE6KD5	Tallari had an outstanding season in Manchester , finishing as the EIHL 's second highest goal scorer , managing 55 goals and 38 assists in 59 games .	15	26	outstanding	4	9	13
3LOJFQ4BOXGY5OO6FNBM7TEUVE6KD5	Tallari had an outstanding season in Manchester , finishing as the EIHL 's second highest goal scorer , managing 55 goals and 38 assists in 59 games .	15	33	outstanding season	1	1	2
3LOJFQ4BOXGY5OO6FNBM7TEUVE6KD5	Tallari had an outstanding season in Manchester , finishing as the EIHL 's second highest goal scorer , managing 55 goals and 38 assists in 59 games .	27	33	season	2	0	2
3LOJFQ4BOXGY5OO6FNBM7TEUVE6KD5	Tallari had an outstanding season in Manchester , finishing as the EIHL 's second highest goal scorer , managing 55 goals and 38 assists in 59 games .	50	59	finishing	0	1	1
3LOJFQ4BOXGY5OO6FNBM7TEUVE6KD5	Tallari had an outstanding season in Manchester , finishing as the EIHL 's second highest goal scorer , managing 55 goals and 38 assists in 59 games .	67	71	EIHL	1	1	2
3LOJFQ4BOXGY5OO6FNBM7TEUVE6KD5	Tallari had an outstanding season in Manchester , finishing as the EIHL 's second highest goal scorer , managing 55 goals and 38 assists in 59 games .	75	101	second highest goal scorer	1	0	1
3LOJFQ4BOXGY5OO6FNBM7TEUVE6KD5	Tallari had an outstanding season in Manchester , finishing as the EIHL 's second highest goal scorer , managing 55 goals and 38 assists in 59 games .	95	101	scorer	1	3	4
3LOJFQ4BOXGY5OO6FNBM7TEUVE6KD5	Tallari had an outstanding season in Manchester , finishing as the EIHL 's second highest goal scorer , managing 55 goals and 38 assists in 59 games .	104	112	managing	1	2	3
3LOJFQ4BOXGY5OO6FNBM7TEUVE6KD5	Tallari had an outstanding season in Manchester , finishing as the EIHL 's second highest goal scorer , managing 55 goals and 38 assists in 59 games .	129	136	assists	0	2	2
3LOJFQ4BOXGY5OO6FNBM7TEUVE6KD5	For example , A0 denotes the hottest stars in the A class and A9 denotes the coolest ones .	17	24	denotes	9	4	13
3LOJFQ4BOXGY5OO6FNBM7TEUVE6KD5	For example , A0 denotes the hottest stars in the A class and A9 denotes the coolest ones .	65	72	denotes	2	2	4
3LOJFQ4BOXGY5OO6FNBM7TEUVE6KD5	For example , A0 denotes the hottest stars in the A class and A9 denotes the coolest ones .	77	84	coolest	1	0	1
3LOJFQ4BOXGY5OO6FNBM7TEUVE6KD5	Notes : The spectral classes O through Y are subdivided by Arabic numerals ( 0-9 ) , which can be further divided into half-subtypes .	12	20	spectral	8	5	13
3LOJFQ4BOXGY5OO6FNBM7TEUVE6KD5	Notes : The spectral classes O through Y are subdivided by Arabic numerals ( 0-9 ) , which can be further divided into half-subtypes .	12	28	spectral classes	3	2	5
3LOJFQ4BOXGY5OO6FNBM7TEUVE6KD5	Notes : The spectral classes O through Y are subdivided by Arabic numerals ( 0-9 ) , which can be further divided into half-subtypes .	45	55	subdivided	4	2	6
3LOJFQ4BOXGY5OO6FNBM7TEUVE6KD5	Notes : The spectral classes O through Y are subdivided by Arabic numerals ( 0-9 ) , which can be further divided into half-subtypes .	66	74	numerals	1	1	2
3LOJFQ4BOXGY5OO6FNBM7TEUVE6KD5	Notes : The spectral classes O through Y are subdivided by Arabic numerals ( 0-9 ) , which can be further divided into half-subtypes .	119	132	half-subtypes	7	5	12
3LOJFQ4BOXGY5OO6FNBM7TEUVE6KD5	Main-sequence stars vary in surface temperature from approximately 2,000 to 50,000 K , whereas more-evolved stars can have temperatures above 100,000 K. Physically , the classes indicate the temperature of the star 's atmosphere and are normally listed from hottest to coldest , as is done in the following table .	0	13	Main-sequence	5	5	10
3LOJFQ4BOXGY5OO6FNBM7TEUVE6KD5	Main-sequence stars vary in surface temperature from approximately 2,000 to 50,000 K , whereas more-evolved stars can have temperatures above 100,000 K. Physically , the classes indicate the temperature of the star 's atmosphere and are normally listed from hottest to coldest , as is done in the following table .	0	19	Main-sequence stars	1	1	2
3LOJFQ4BOXGY5OO6FNBM7TEUVE6KD5	Main-sequence stars vary in surface temperature from approximately 2,000 to 50,000 K , whereas more-evolved stars can have temperatures above 100,000 K. Physically , the classes indicate the temperature of the star 's atmosphere and are normally listed from hottest to coldest , as is done in the following table .	28	35	surface	1	1	2
3LOJFQ4BOXGY5OO6FNBM7TEUVE6KD5	Main-sequence stars vary in surface temperature from approximately 2,000 to 50,000 K , whereas more-evolved stars can have temperatures above 100,000 K. Physically , the classes indicate the temperature of the star 's atmosphere and are normally listed from hottest to coldest , as is done in the following table .	28	47	surface temperature	1	0	1
3LOJFQ4BOXGY5OO6FNBM7TEUVE6KD5	Main-sequence stars vary in surface temperature from approximately 2,000 to 50,000 K , whereas more-evolved stars can have temperatures above 100,000 K. Physically , the classes indicate the temperature of the star 's atmosphere and are normally listed from hottest to coldest , as is done in the following table .	36	47	temperature	3	0	3
3LOJFQ4BOXGY5OO6FNBM7TEUVE6KD5	Main-sequence stars vary in surface temperature from approximately 2,000 to 50,000 K , whereas more-evolved stars can have temperatures above 100,000 K. Physically , the classes indicate the temperature of the star 's atmosphere and are normally listed from hottest to coldest , as is done in the following table .	53	66	approximately	2	2	4
3LOJFQ4BOXGY5OO6FNBM7TEUVE6KD5	Main-sequence stars vary in surface temperature from approximately 2,000 to 50,000 K , whereas more-evolved stars can have temperatures above 100,000 K. Physically , the classes indicate the temperature of the star 's atmosphere and are normally listed from hottest to coldest , as is done in the following table .	87	94	whereas	2	2	4
3LOJFQ4BOXGY5OO6FNBM7TEUVE6KD5	Main-sequence stars vary in surface temperature from approximately 2,000 to 50,000 K , whereas more-evolved stars can have temperatures above 100,000 K. Physically , the classes indicate the temperature of the star 's atmosphere and are normally listed from hottest to coldest , as is done in the following table .	95	107	more-evolved	4	3	7
3LOJFQ4BOXGY5OO6FNBM7TEUVE6KD5	Main-sequence stars vary in surface temperature from approximately 2,000 to 50,000 K , whereas more-evolved stars can have temperatures above 100,000 K. Physically , the classes indicate the temperature of the star 's atmosphere and are normally listed from hottest to coldest , as is done in the following table .	95	113	more-evolved stars	0	1	1
3LOJFQ4BOXGY5OO6FNBM7TEUVE6KD5	Main-sequence stars vary in surface temperature from approximately 2,000 to 50,000 K , whereas more-evolved stars can have temperatures above 100,000 K. Physically , the classes indicate the temperature of the star 's atmosphere and are normally listed from hottest to coldest , as is done in the following table .	123	135	temperatures	1	0	1
3LOJFQ4BOXGY5OO6FNBM7TEUVE6KD5	Main-sequence stars vary in surface temperature from approximately 2,000 to 50,000 K , whereas more-evolved stars can have temperatures above 100,000 K. Physically , the classes indicate the temperature of the star 's atmosphere and are normally listed from hottest to coldest , as is done in the following table .	153	163	Physically	2	0	2
3LOJFQ4BOXGY5OO6FNBM7TEUVE6KD5	Main-sequence stars vary in surface temperature from approximately 2,000 to 50,000 K , whereas more-evolved stars can have temperatures above 100,000 K. Physically , the classes indicate the temperature of the star 's atmosphere and are normally listed from hottest to coldest , as is done in the following table .	178	186	indicate	1	4	5
3LOJFQ4BOXGY5OO6FNBM7TEUVE6KD5	Main-sequence stars vary in surface temperature from approximately 2,000 to 50,000 K , whereas more-evolved stars can have temperatures above 100,000 K. Physically , the classes indicate the temperature of the star 's atmosphere and are normally listed from hottest to coldest , as is done in the following table .	218	228	atmosphere	8	3	11
3LOJFQ4BOXGY5OO6FNBM7TEUVE6KD5	Main-sequence stars vary in surface temperature from approximately 2,000 to 50,000 K , whereas more-evolved stars can have temperatures above 100,000 K. Physically , the classes indicate the temperature of the star 's atmosphere and are normally listed from hottest to coldest , as is done in the following table .	237	245	normally	0	1	1
3LOJFQ4BOXGY5OO6FNBM7TEUVE6KD5	While some users can use them to circumvent censorship or filters , they have been used far too many times by far too many blocked vandals for Wikipedians to assume good faith on their part .	33	43	circumvent	10	9	19
3LOJFQ4BOXGY5OO6FNBM7TEUVE6KD5	While some users can use them to circumvent censorship or filters , they have been used far too many times by far too many blocked vandals for Wikipedians to assume good faith on their part .	33	54	circumvent censorship	2	2	4
3LOJFQ4BOXGY5OO6FNBM7TEUVE6KD5	While some users can use them to circumvent censorship or filters , they have been used far too many times by far too many blocked vandals for Wikipedians to assume good faith on their part .	44	54	censorship	7	3	10
3LOJFQ4BOXGY5OO6FNBM7TEUVE6KD5	While some users can use them to circumvent censorship or filters , they have been used far too many times by far too many blocked vandals for Wikipedians to assume good faith on their part .	58	65	filters	1	0	1
3LOJFQ4BOXGY5OO6FNBM7TEUVE6KD5	While some users can use them to circumvent censorship or filters , they have been used far too many times by far too many blocked vandals for Wikipedians to assume good faith on their part .	123	138	blocked vandals	0	1	1
3LOJFQ4BOXGY5OO6FNBM7TEUVE6KD5	While some users can use them to circumvent censorship or filters , they have been used far too many times by far too many blocked vandals for Wikipedians to assume good faith on their part .	131	138	vandals	6	4	10
3LOJFQ4BOXGY5OO6FNBM7TEUVE6KD5	While some users can use them to circumvent censorship or filters , they have been used far too many times by far too many blocked vandals for Wikipedians to assume good faith on their part .	143	154	Wikipedians	4	0	4
3LOJFQ4BOXGY5OO6FNBM7TEUVE6KD5	While some users can use them to circumvent censorship or filters , they have been used far too many times by far too many blocked vandals for Wikipedians to assume good faith on their part .	158	164	assume	2	3	5
3LOJFQ4BOXGY5OO6FNBM7TEUVE6KD5	While some users can use them to circumvent censorship or filters , they have been used far too many times by far too many blocked vandals for Wikipedians to assume good faith on their part .	165	175	good faith	1	0	1
3PEG1BH7AES5QRQM1RKGC3QUSTUKBY	In May 1997 he was appointed to the Trial Division of the Supreme Court of Victoria , and in October 1998 to the Court of Appeal of that Court .	19	28	appointed	7	3	10
3PEG1BH7AES5QRQM1RKGC3QUSTUKBY	In May 1997 he was appointed to the Trial Division of the Supreme Court of Victoria , and in October 1998 to the Court of Appeal of that Court .	36	41	Trial	2	1	3
3PEG1BH7AES5QRQM1RKGC3QUSTUKBY	In May 1997 he was appointed to the Trial Division of the Supreme Court of Victoria , and in October 1998 to the Court of Appeal of that Court .	36	50	Trial Division	2	1	3
3PEG1BH7AES5QRQM1RKGC3QUSTUKBY	In May 1997 he was appointed to the Trial Division of the Supreme Court of Victoria , and in October 1998 to the Court of Appeal of that Court .	36	71	Trial Division of the Supreme Court	1	0	1
3PEG1BH7AES5QRQM1RKGC3QUSTUKBY	In May 1997 he was appointed to the Trial Division of the Supreme Court of Victoria , and in October 1998 to the Court of Appeal of that Court .	58	65	Supreme	0	1	1
3PEG1BH7AES5QRQM1RKGC3QUSTUKBY	In May 1997 he was appointed to the Trial Division of the Supreme Court of Victoria , and in October 1998 to the Court of Appeal of that Court .	58	71	Supreme Court	1	0	1
3PEG1BH7AES5QRQM1RKGC3QUSTUKBY	In May 1997 he was appointed to the Trial Division of the Supreme Court of Victoria , and in October 1998 to the Court of Appeal of that Court .	113	128	Court of Appeal	3	3	6
3PEG1BH7AES5QRQM1RKGC3QUSTUKBY	In May 1997 he was appointed to the Trial Division of the Supreme Court of Victoria , and in October 1998 to the Court of Appeal of that Court .	122	128	Appeal	1	2	3
3PEG1BH7AES5QRQM1RKGC3QUSTUKBY	He was elected the 20th Chancellor of the University of Melbourne in January 2009 , serving in that office until he resigned to take up the office of Governor of Victoria .	7	14	elected	1	1	2
3PEG1BH7AES5QRQM1RKGC3QUSTUKBY	He was elected the 20th Chancellor of the University of Melbourne in January 2009 , serving in that office until he resigned to take up the office of Governor of Victoria .	24	34	Chancellor	6	7	13
3PEG1BH7AES5QRQM1RKGC3QUSTUKBY	He was elected the 20th Chancellor of the University of Melbourne in January 2009 , serving in that office until he resigned to take up the office of Governor of Victoria .	42	52	University	1	0	1
3PEG1BH7AES5QRQM1RKGC3QUSTUKBY	He was elected the 20th Chancellor of the University of Melbourne in January 2009 , serving in that office until he resigned to take up the office of Governor of Victoria .	84	91	serving	1	0	1
3PEG1BH7AES5QRQM1RKGC3QUSTUKBY	He was elected the 20th Chancellor of the University of Melbourne in January 2009 , serving in that office until he resigned to take up the office of Governor of Victoria .	116	124	resigned	8	9	17
3PEG1BH7AES5QRQM1RKGC3QUSTUKBY	He was elected the 20th Chancellor of the University of Melbourne in January 2009 , serving in that office until he resigned to take up the office of Governor of Victoria .	125	135	to take up	1	0	1
3PEG1BH7AES5QRQM1RKGC3QUSTUKBY	He was elected the 20th Chancellor of the University of Melbourne in January 2009 , serving in that office until he resigned to take up the office of Governor of Victoria .	150	158	Governor	1	0	1
3PEG1BH7AES5QRQM1RKGC3QUSTUKBY	On 21 February 2011 , it was announced that he would become the 28th Governor of Victoria .	29	38	announced	4	3	7
3PEG1BH7AES5QRQM1RKGC3QUSTUKBY	On 21 February 2011 , it was announced that he would become the 28th Governor of Victoria .	69	77	Governor	1	0	1
3PEG1BH7AES5QRQM1RKGC3QUSTUKBY	Chernov was appointed Queen 's Counsel in and for the State of Victoria in 1980 .	0	7	Chernov	1	0	1
3PEG1BH7AES5QRQM1RKGC3QUSTUKBY	Chernov was appointed Queen 's Counsel in and for the State of Victoria in 1980 .	12	21	appointed	4	3	7
3PEG1BH7AES5QRQM1RKGC3QUSTUKBY	Chernov was appointed Queen 's Counsel in and for the State of Victoria in 1980 .	22	37	Queen s Counsel	1	0	1
3PEG1BH7AES5QRQM1RKGC3QUSTUKBY	Chernov was appointed Queen 's Counsel in and for the State of Victoria in 1980 .	31	38	Counsel	2	6	8
3PEG1BH7AES5QRQM1RKGC3QUSTUKBY	Chernov was created an Officer of the Order of Australia in the 2007 Queen 's Birthday Honours list for service to the law and education .	0	7	Chernov	1	1	2
3PEG1BH7AES5QRQM1RKGC3QUSTUKBY	Chernov was created an Officer of the Order of Australia in the 2007 Queen 's Birthday Honours list for service to the law and education .	12	19	created	0	2	2
3PEG1BH7AES5QRQM1RKGC3QUSTUKBY	Chernov was created an Officer of the Order of Australia in the 2007 Queen 's Birthday Honours list for service to the law and education .	23	30	Officer	1	0	1
3PEG1BH7AES5QRQM1RKGC3QUSTUKBY	Chernov was created an Officer of the Order of Australia in the 2007 Queen 's Birthday Honours list for service to the law and education .	38	56	Order of Australia	1	0	1
3PEG1BH7AES5QRQM1RKGC3QUSTUKBY	Chernov was created an Officer of the Order of Australia in the 2007 Queen 's Birthday Honours list for service to the law and education .	69	98	Queen s Birthday Honours list	1	0	1
3PEG1BH7AES5QRQM1RKGC3QUSTUKBY	Chernov was created an Officer of the Order of Australia in the 2007 Queen 's Birthday Honours list for service to the law and education .	78	94	Birthday Honours	0	1	1
3PEG1BH7AES5QRQM1RKGC3QUSTUKBY	Chernov was created an Officer of the Order of Australia in the 2007 Queen 's Birthday Honours list for service to the law and education .	87	94	Honours	5	5	10
3PEG1BH7AES5QRQM1RKGC3QUSTUKBY	Chernov was created an Officer of the Order of Australia in the 2007 Queen 's Birthday Honours list for service to the law and education .	87	99	Honours list	0	3	3
3PEG1BH7AES5QRQM1RKGC3QUSTUKBY	Chernov was created an Officer of the Order of Australia in the 2007 Queen 's Birthday Honours list for service to the law and education .	127	136	education	1	0	1
3PEG1BH7AES5QRQM1RKGC3QUSTUKBY	On 26 January 2011 , Chernov was named a Companion of the Order of Australia .	21	28	Chernov	1	0	1
3PEG1BH7AES5QRQM1RKGC3QUSTUKBY	On 26 January 2011 , Chernov was named a Companion of the Order of Australia .	41	50	Companion	4	8	12
3PEG1BH7AES5QRQM1RKGC3QUSTUKBY	On 26 January 2011 , Chernov was named a Companion of the Order of Australia .	41	63	Companion of the Order	1	0	1
3PEG1BH7AES5QRQM1RKGC3QUSTUKBY	On 26 January 2011 , Chernov was named a Companion of the Order of Australia .	41	76	Companion of the Order of Australia	1	0	1
37MQ8Z1JQEX6MJF7MDSWKI21W2Q2Y9	The bean was first unearthed at Awazu-kotei Ruin of Japanese mid Jōmon period in 4000BC , and later it was commonly found on many Jomon ruins in 4000BC to 2000BC in Japan .	4	8	bean	1	1	2
37MQ8Z1JQEX6MJF7MDSWKI21W2Q2Y9	The bean was first unearthed at Awazu-kotei Ruin of Japanese mid Jōmon period in 4000BC , and later it was commonly found on many Jomon ruins in 4000BC to 2000BC in Japan .	19	28	unearthed	10	10	20
37MQ8Z1JQEX6MJF7MDSWKI21W2Q2Y9	The bean was first unearthed at Awazu-kotei Ruin of Japanese mid Jōmon period in 4000BC , and later it was commonly found on many Jomon ruins in 4000BC to 2000BC in Japan .	32	43	Awazu-kotei	1	0	1
37MQ8Z1JQEX6MJF7MDSWKI21W2Q2Y9	The bean was first unearthed at Awazu-kotei Ruin of Japanese mid Jōmon period in 4000BC , and later it was commonly found on many Jomon ruins in 4000BC to 2000BC in Japan .	44	48	Ruin	1	0	1
37MQ8Z1JQEX6MJF7MDSWKI21W2Q2Y9	The bean was first unearthed at Awazu-kotei Ruin of Japanese mid Jōmon period in 4000BC , and later it was commonly found on many Jomon ruins in 4000BC to 2000BC in Japan .	65	70	Jōmon	3	0	3
37MQ8Z1JQEX6MJF7MDSWKI21W2Q2Y9	The bean was first unearthed at Awazu-kotei Ruin of Japanese mid Jōmon period in 4000BC , and later it was commonly found on many Jomon ruins in 4000BC to 2000BC in Japan .	130	135	Jomon	1	0	1
37MQ8Z1JQEX6MJF7MDSWKI21W2Q2Y9	The bean was first unearthed at Awazu-kotei Ruin of Japanese mid Jōmon period in 4000BC , and later it was commonly found on many Jomon ruins in 4000BC to 2000BC in Japan .	136	141	ruins	2	3	5
37MQ8Z1JQEX6MJF7MDSWKI21W2Q2Y9	In particular , it is often boiled with sugar , resulting in red bean paste ( an ) , a very common ingredient in all of these cuisines .	3	13	particular	1	0	1
37MQ8Z1JQEX6MJF7MDSWKI21W2Q2Y9	In particular , it is often boiled with sugar , resulting in red bean paste ( an ) , a very common ingredient in all of these cuisines .	28	34	boiled	1	3	4
37MQ8Z1JQEX6MJF7MDSWKI21W2Q2Y9	In particular , it is often boiled with sugar , resulting in red bean paste ( an ) , a very common ingredient in all of these cuisines .	48	57	resulting	1	0	1
37MQ8Z1JQEX6MJF7MDSWKI21W2Q2Y9	In particular , it is often boiled with sugar , resulting in red bean paste ( an ) , a very common ingredient in all of these cuisines .	99	109	ingredient	6	6	12
37MQ8Z1JQEX6MJF7MDSWKI21W2Q2Y9	In particular , it is often boiled with sugar , resulting in red bean paste ( an ) , a very common ingredient in all of these cuisines .	126	134	cuisines	9	6	15
37MQ8Z1JQEX6MJF7MDSWKI21W2Q2Y9	In Japan , rice with azuki beans ( 赤飯 ; sekihan ) is traditionally cooked for auspicious occasions .	21	26	azuki	2	1	3
37MQ8Z1JQEX6MJF7MDSWKI21W2Q2Y9	In Japan , rice with azuki beans ( 赤飯 ; sekihan ) is traditionally cooked for auspicious occasions .	21	32	azuki beans	2	0	2
37MQ8Z1JQEX6MJF7MDSWKI21W2Q2Y9	In Japan , rice with azuki beans ( 赤飯 ; sekihan ) is traditionally cooked for auspicious occasions .	40	47	sekihan	1	0	1
37MQ8Z1JQEX6MJF7MDSWKI21W2Q2Y9	In Japan , rice with azuki beans ( 赤飯 ; sekihan ) is traditionally cooked for auspicious occasions .	53	66	traditionally	3	2	5
37MQ8Z1JQEX6MJF7MDSWKI21W2Q2Y9	In Japan , rice with azuki beans ( 赤飯 ; sekihan ) is traditionally cooked for auspicious occasions .	78	88	auspicious	10	8	18
37MQ8Z1JQEX6MJF7MDSWKI21W2Q2Y9	In Japan , rice with azuki beans ( 赤飯 ; sekihan ) is traditionally cooked for auspicious occasions .	78	98	auspicious occasions	2	1	3
37MQ8Z1JQEX6MJF7MDSWKI21W2Q2Y9	Gingerbread was brought to Europe in 992 by the Armenian monk Gregory of Nicopolis ( Gregory Makar ) ( Grégoire de Nicopolis ) .	0	11	Gingerbread	3	2	5
37MQ8Z1JQEX6MJF7MDSWKI21W2Q2Y9	Gingerbread was brought to Europe in 992 by the Armenian monk Gregory of Nicopolis ( Gregory Makar ) ( Grégoire de Nicopolis ) .	48	56	Armenian	1	0	1
37MQ8Z1JQEX6MJF7MDSWKI21W2Q2Y9	Gingerbread was brought to Europe in 992 by the Armenian monk Gregory of Nicopolis ( Gregory Makar ) ( Grégoire de Nicopolis ) .	57	61	monk	2	3	5
37MQ8Z1JQEX6MJF7MDSWKI21W2Q2Y9	Gingerbread was brought to Europe in 992 by the Armenian monk Gregory of Nicopolis ( Gregory Makar ) ( Grégoire de Nicopolis ) .	115	124	Nicopolis	1	0	1
37MQ8Z1JQEX6MJF7MDSWKI21W2Q2Y9	The first documented trade of gingerbread biscuits dates to the 17th century , where they were sold in monasteries , pharmacies and town square farmers ' markets .	10	20	documented	4	1	5
37MQ8Z1JQEX6MJF7MDSWKI21W2Q2Y9	The first documented trade of gingerbread biscuits dates to the 17th century , where they were sold in monasteries , pharmacies and town square farmers ' markets .	10	26	documented trade	0	1	1
37MQ8Z1JQEX6MJF7MDSWKI21W2Q2Y9	The first documented trade of gingerbread biscuits dates to the 17th century , where they were sold in monasteries , pharmacies and town square farmers ' markets .	30	41	gingerbread	2	2	4
37MQ8Z1JQEX6MJF7MDSWKI21W2Q2Y9	The first documented trade of gingerbread biscuits dates to the 17th century , where they were sold in monasteries , pharmacies and town square farmers ' markets .	42	50	biscuits	3	1	4
37MQ8Z1JQEX6MJF7MDSWKI21W2Q2Y9	The first documented trade of gingerbread biscuits dates to the 17th century , where they were sold in monasteries , pharmacies and town square farmers ' markets .	103	114	monasteries	10	9	19
37MQ8Z1JQEX6MJF7MDSWKI21W2Q2Y9	The first documented trade of gingerbread biscuits dates to the 17th century , where they were sold in monasteries , pharmacies and town square farmers ' markets .	116	127	 pharmacies	1	0	1
37MQ8Z1JQEX6MJF7MDSWKI21W2Q2Y9	The first documented trade of gingerbread biscuits dates to the 17th century , where they were sold in monasteries , pharmacies and town square farmers ' markets .	117	127	pharmacies	7	3	10
37MQ8Z1JQEX6MJF7MDSWKI21W2Q2Y9	The first documented trade of gingerbread biscuits dates to the 17th century , where they were sold in monasteries , pharmacies and town square farmers ' markets .	137	160	square farmers  markets	0	1	1
3K2CEDRACB20C1K6MPOHRAOKN5PMTV	During the 2000s , Romania implemented a number of reforms to prepare for EU accession , including the consolidation of its democratic systems , the institution of the rule of law , the acknowledgement of respect for human rights , the commitment to personal freedom of expression , and the implementation of a functioning free-market economy .	27	38	implemented	7	6	13
3K2CEDRACB20C1K6MPOHRAOKN5PMTV	During the 2000s , Romania implemented a number of reforms to prepare for EU accession , including the consolidation of its democratic systems , the institution of the rule of law , the acknowledgement of respect for human rights , the commitment to personal freedom of expression , and the implementation of a functioning free-market economy .	51	58	reforms	3	2	5
3K2CEDRACB20C1K6MPOHRAOKN5PMTV	During the 2000s , Romania implemented a number of reforms to prepare for EU accession , including the consolidation of its democratic systems , the institution of the rule of law , the acknowledgement of respect for human rights , the commitment to personal freedom of expression , and the implementation of a functioning free-market economy .	74	86	EU accession	1	0	1
3K2CEDRACB20C1K6MPOHRAOKN5PMTV	During the 2000s , Romania implemented a number of reforms to prepare for EU accession , including the consolidation of its democratic systems , the institution of the rule of law , the acknowledgement of respect for human rights , the commitment to personal freedom of expression , and the implementation of a functioning free-market economy .	77	86	accession	9	6	15
3K2CEDRACB20C1K6MPOHRAOKN5PMTV	During the 2000s , Romania implemented a number of reforms to prepare for EU accession , including the consolidation of its democratic systems , the institution of the rule of law , the acknowledgement of respect for human rights , the commitment to personal freedom of expression , and the implementation of a functioning free-market economy .	103	116	consolidation	10	8	18
3K2CEDRACB20C1K6MPOHRAOKN5PMTV	During the 2000s , Romania implemented a number of reforms to prepare for EU accession , including the consolidation of its democratic systems , the institution of the rule of law , the acknowledgement of respect for human rights , the commitment to personal freedom of expression , and the implementation of a functioning free-market economy .	124	134	democratic	4	1	5
3K2CEDRACB20C1K6MPOHRAOKN5PMTV	During the 2000s , Romania implemented a number of reforms to prepare for EU accession , including the consolidation of its democratic systems , the institution of the rule of law , the acknowledgement of respect for human rights , the commitment to personal freedom of expression , and the implementation of a functioning free-market economy .	124	142	democratic systems	1	0	1
3K2CEDRACB20C1K6MPOHRAOKN5PMTV	During the 2000s , Romania implemented a number of reforms to prepare for EU accession , including the consolidation of its democratic systems , the institution of the rule of law , the acknowledgement of respect for human rights , the commitment to personal freedom of expression , and the implementation of a functioning free-market economy .	135	142	systems	1	0	1
3K2CEDRACB20C1K6MPOHRAOKN5PMTV	During the 2000s , Romania implemented a number of reforms to prepare for EU accession , including the consolidation of its democratic systems , the institution of the rule of law , the acknowledgement of respect for human rights , the commitment to personal freedom of expression , and the implementation of a functioning free-market economy .	149	160	institution	6	1	7
3K2CEDRACB20C1K6MPOHRAOKN5PMTV	During the 2000s , Romania implemented a number of reforms to prepare for EU accession , including the consolidation of its democratic systems , the institution of the rule of law , the acknowledgement of respect for human rights , the commitment to personal freedom of expression , and the implementation of a functioning free-market economy .	168	179	rule of law	0	1	1
3K2CEDRACB20C1K6MPOHRAOKN5PMTV	During the 2000s , Romania implemented a number of reforms to prepare for EU accession , including the consolidation of its democratic systems , the institution of the rule of law , the acknowledgement of respect for human rights , the commitment to personal freedom of expression , and the implementation of a functioning free-market economy .	186	201	acknowledgement	6	6	12
3K2CEDRACB20C1K6MPOHRAOKN5PMTV	During the 2000s , Romania implemented a number of reforms to prepare for EU accession , including the consolidation of its democratic systems , the institution of the rule of law , the acknowledgement of respect for human rights , the commitment to personal freedom of expression , and the implementation of a functioning free-market economy .	236	246	commitment	1	4	5
3K2CEDRACB20C1K6MPOHRAOKN5PMTV	During the 2000s , Romania implemented a number of reforms to prepare for EU accession , including the consolidation of its democratic systems , the institution of the rule of law , the acknowledgement of respect for human rights , the commitment to personal freedom of expression , and the implementation of a functioning free-market economy .	270	280	expression	1	2	3
3K2CEDRACB20C1K6MPOHRAOKN5PMTV	During the 2000s , Romania implemented a number of reforms to prepare for EU accession , including the consolidation of its democratic systems , the institution of the rule of law , the acknowledgement of respect for human rights , the commitment to personal freedom of expression , and the implementation of a functioning free-market economy .	291	305	implementation	7	3	10
3K2CEDRACB20C1K6MPOHRAOKN5PMTV	During the 2000s , Romania implemented a number of reforms to prepare for EU accession , including the consolidation of its democratic systems , the institution of the rule of law , the acknowledgement of respect for human rights , the commitment to personal freedom of expression , and the implementation of a functioning free-market economy .	311	322	functioning	2	0	2
3K2CEDRACB20C1K6MPOHRAOKN5PMTV	During the 2000s , Romania implemented a number of reforms to prepare for EU accession , including the consolidation of its democratic systems , the institution of the rule of law , the acknowledgement of respect for human rights , the commitment to personal freedom of expression , and the implementation of a functioning free-market economy .	311	342	functioning free-market economy	0	1	1
3K2CEDRACB20C1K6MPOHRAOKN5PMTV	During the 2000s , Romania implemented a number of reforms to prepare for EU accession , including the consolidation of its democratic systems , the institution of the rule of law , the acknowledgement of respect for human rights , the commitment to personal freedom of expression , and the implementation of a functioning free-market economy .	323	334	free-market	1	2	3
3K2CEDRACB20C1K6MPOHRAOKN5PMTV	During the 2000s , Romania implemented a number of reforms to prepare for EU accession , including the consolidation of its democratic systems , the institution of the rule of law , the acknowledgement of respect for human rights , the commitment to personal freedom of expression , and the implementation of a functioning free-market economy .	323	342	free-market economy	3	1	4
3K2CEDRACB20C1K6MPOHRAOKN5PMTV	Acherontia atropos is the most widely-known of the three species of Death 's - head Hawk moth .	0	10	Acherontia	1	1	2
3K2CEDRACB20C1K6MPOHRAOKN5PMTV	Acherontia atropos is the most widely-known of the three species of Death 's - head Hawk moth .	0	18	Acherontia atropos	7	3	10
3K2CEDRACB20C1K6MPOHRAOKN5PMTV	Acherontia atropos is the most widely-known of the three species of Death 's - head Hawk moth .	11	18	atropos	2	1	3
3K2CEDRACB20C1K6MPOHRAOKN5PMTV	Acherontia atropos is the most widely-known of the three species of Death 's - head Hawk moth .	31	43	widely-known	0	3	3
3K2CEDRACB20C1K6MPOHRAOKN5PMTV	Acherontia atropos is the most widely-known of the three species of Death 's - head Hawk moth .	79	93	head Hawk moth	1	0	1
3K2CEDRACB20C1K6MPOHRAOKN5PMTV	Acherontia atropos is the most widely-known of the three species of Death 's - head Hawk moth .	84	93	Hawk moth	0	1	1
3K2CEDRACB20C1K6MPOHRAOKN5PMTV	Acherontia atropos is the most widely-known of the three species of Death 's - head Hawk moth .	89	93	moth	0	2	2
3K2CEDRACB20C1K6MPOHRAOKN5PMTV	It often accompanies this sound with flashing its brightly marked abdomen in a further attempt to deter its predators .	9	20	accompanies	2	1	3
3K2CEDRACB20C1K6MPOHRAOKN5PMTV	It often accompanies this sound with flashing its brightly marked abdomen in a further attempt to deter its predators .	37	45	flashing	0	1	1
3K2CEDRACB20C1K6MPOHRAOKN5PMTV	It often accompanies this sound with flashing its brightly marked abdomen in a further attempt to deter its predators .	66	73	abdomen	6	1	7
3K2CEDRACB20C1K6MPOHRAOKN5PMTV	It often accompanies this sound with flashing its brightly marked abdomen in a further attempt to deter its predators .	98	103	deter	3	7	10
3K2CEDRACB20C1K6MPOHRAOKN5PMTV	It often accompanies this sound with flashing its brightly marked abdomen in a further attempt to deter its predators .	108	117	predators	4	10	14
3K2CEDRACB20C1K6MPOHRAOKN5PMTV	Unlike the other species of Acherontia , it only attacks colonies of the well-known Western honey bee , Apis mellifera .	17	24	species	0	1	1
3K2CEDRACB20C1K6MPOHRAOKN5PMTV	Unlike the other species of Acherontia , it only attacks colonies of the well-known Western honey bee , Apis mellifera .	28	38	Acherontia	2	2	4
3K2CEDRACB20C1K6MPOHRAOKN5PMTV	Unlike the other species of Acherontia , it only attacks colonies of the well-known Western honey bee , Apis mellifera .	57	65	colonies	2	0	2
3K2CEDRACB20C1K6MPOHRAOKN5PMTV	Unlike the other species of Acherontia , it only attacks colonies of the well-known Western honey bee , Apis mellifera .	104	118	Apis mellifera	5	1	6
3K2CEDRACB20C1K6MPOHRAOKN5PMTV	Unlike the other species of Acherontia , it only attacks colonies of the well-known Western honey bee , Apis mellifera .	109	118	mellifera	0	1	1
3K2CEDRACB20C1K6MPOHRAOKN5PMTV	It is able to move about in hives unmolested because it mimics the scent of the bees .	28	33	hives	0	1	1
3K2CEDRACB20C1K6MPOHRAOKN5PMTV	It is able to move about in hives unmolested because it mimics the scent of the bees .	28	44	hives unmolested	0	1	1
3K2CEDRACB20C1K6MPOHRAOKN5PMTV	It is able to move about in hives unmolested because it mimics the scent of the bees .	34	44	unmolested	10	10	20
3K2CEDRACB20C1K6MPOHRAOKN5PMTV	It is able to move about in hives unmolested because it mimics the scent of the bees .	56	62	mimics	4	4	8
3K2CEDRACB20C1K6MPOHRAOKN5PMTV	It is able to move about in hives unmolested because it mimics the scent of the bees .	67	72	scent	0	1	1
3K2CEDRACB20C1K6MPOHRAOKN5PMTV	It is able to move about in hives unmolested because it mimics the scent of the bees .	80	84	bees	1	0	1
3VCK0Q0PO5F5EA8F0OF7KEBFVK2N0K	Today , GD 165B is recognized as the prototype of a class of objects now called `` L dwarfs '' .	19	29	recognized	1	2	3
3VCK0Q0PO5F5EA8F0OF7KEBFVK2N0K	Today , GD 165B is recognized as the prototype of a class of objects now called `` L dwarfs '' .	19	46	recognized as the prototype	1	0	1
3VCK0Q0PO5F5EA8F0OF7KEBFVK2N0K	Today , GD 165B is recognized as the prototype of a class of objects now called `` L dwarfs '' .	37	46	prototype	9	10	19
3VCK0Q0PO5F5EA8F0OF7KEBFVK2N0K	Today , GD 165B is recognized as the prototype of a class of objects now called `` L dwarfs '' .	83	91	L dwarfs	0	1	1
3VCK0Q0PO5F5EA8F0OF7KEBFVK2N0K	Today , GD 165B is recognized as the prototype of a class of objects now called `` L dwarfs '' .	85	91	dwarfs	1	4	5
3VCK0Q0PO5F5EA8F0OF7KEBFVK2N0K	Most failed to live up to their candidacy , however , because the absence of lithium showed them to be stellar objects .	0	41	Most failed to live up to their candidacy	0	1	1
3VCK0Q0PO5F5EA8F0OF7KEBFVK2N0K	Most failed to live up to their candidacy , however , because the absence of lithium showed them to be stellar objects .	32	41	candidacy	9	10	19
3VCK0Q0PO5F5EA8F0OF7KEBFVK2N0K	Most failed to live up to their candidacy , however , because the absence of lithium showed them to be stellar objects .	66	73	absence	1	3	4
3VCK0Q0PO5F5EA8F0OF7KEBFVK2N0K	Most failed to live up to their candidacy , however , because the absence of lithium showed them to be stellar objects .	66	84	absence of lithium	1	0	1
3VCK0Q0PO5F5EA8F0OF7KEBFVK2N0K	Most failed to live up to their candidacy , however , because the absence of lithium showed them to be stellar objects .	77	84	lithium	4	2	6
3VCK0Q0PO5F5EA8F0OF7KEBFVK2N0K	Most failed to live up to their candidacy , however , because the absence of lithium showed them to be stellar objects .	103	110	stellar	5	7	12
3VCK0Q0PO5F5EA8F0OF7KEBFVK2N0K	Most failed to live up to their candidacy , however , because the absence of lithium showed them to be stellar objects .	103	118	stellar objects	3	3	6
3VCK0Q0PO5F5EA8F0OF7KEBFVK2N0K	Their strongest emissions are in the infrared ( IR ) spectrum , and ground-based IR detectors were too imprecise at that time to readily identify any brown dwarfs .	16	25	emissions	10	9	19
3VCK0Q0PO5F5EA8F0OF7KEBFVK2N0K	Their strongest emissions are in the infrared ( IR ) spectrum , and ground-based IR detectors were too imprecise at that time to readily identify any brown dwarfs .	37	45	infrared	3	3	6
3VCK0Q0PO5F5EA8F0OF7KEBFVK2N0K	Their strongest emissions are in the infrared ( IR ) spectrum , and ground-based IR detectors were too imprecise at that time to readily identify any brown dwarfs .	37	50	infrared ( IR	2	1	3
3VCK0Q0PO5F5EA8F0OF7KEBFVK2N0K	Their strongest emissions are in the infrared ( IR ) spectrum , and ground-based IR detectors were too imprecise at that time to readily identify any brown dwarfs .	53	61	spectrum	4	3	7
3VCK0Q0PO5F5EA8F0OF7KEBFVK2N0K	Their strongest emissions are in the infrared ( IR ) spectrum , and ground-based IR detectors were too imprecise at that time to readily identify any brown dwarfs .	68	80	ground-based	1	3	4
3VCK0Q0PO5F5EA8F0OF7KEBFVK2N0K	Their strongest emissions are in the infrared ( IR ) spectrum , and ground-based IR detectors were too imprecise at that time to readily identify any brown dwarfs .	68	93	ground-based IR detectors	1	0	1
3VCK0Q0PO5F5EA8F0OF7KEBFVK2N0K	Their strongest emissions are in the infrared ( IR ) spectrum , and ground-based IR detectors were too imprecise at that time to readily identify any brown dwarfs .	81	93	IR detectors	0	1	1
3VCK0Q0PO5F5EA8F0OF7KEBFVK2N0K	Their strongest emissions are in the infrared ( IR ) spectrum , and ground-based IR detectors were too imprecise at that time to readily identify any brown dwarfs .	84	93	detectors	3	3	6
3VCK0Q0PO5F5EA8F0OF7KEBFVK2N0K	Their strongest emissions are in the infrared ( IR ) spectrum , and ground-based IR detectors were too imprecise at that time to readily identify any brown dwarfs .	103	112	imprecise	6	10	16
3VCK0Q0PO5F5EA8F0OF7KEBFVK2N0K	Their strongest emissions are in the infrared ( IR ) spectrum , and ground-based IR detectors were too imprecise at that time to readily identify any brown dwarfs .	129	136	readily	0	1	1
3VCK0Q0PO5F5EA8F0OF7KEBFVK2N0K	Their strongest emissions are in the infrared ( IR ) spectrum , and ground-based IR detectors were too imprecise at that time to readily identify any brown dwarfs .	150	162	brown dwarfs	2	2	4
3VCK0Q0PO5F5EA8F0OF7KEBFVK2N0K	Their strongest emissions are in the infrared ( IR ) spectrum , and ground-based IR detectors were too imprecise at that time to readily identify any brown dwarfs .	156	162	dwarfs	2	4	6
3VCK0Q0PO5F5EA8F0OF7KEBFVK2N0K	However , such objects were hard to find because they emit almost no visible light .	54	58	emit	3	2	5
3VCK0Q0PO5F5EA8F0OF7KEBFVK2N0K	Nature highlighted `` Brown dwarfs discovered , official '' in the front page of that issue .	7	18	highlighted	0	1	1
3VCK0Q0PO5F5EA8F0OF7KEBFVK2N0K	Nature highlighted `` Brown dwarfs discovered , official '' in the front page of that issue .	22	45	Brown dwarfs discovered	1	0	1
3VCK0Q0PO5F5EA8F0OF7KEBFVK2N0K	Nature highlighted `` Brown dwarfs discovered , official '' in the front page of that issue .	28	34	dwarfs	0	1	1
3VCK0Q0PO5F5EA8F0OF7KEBFVK2N0K	Nature highlighted `` Brown dwarfs discovered , official '' in the front page of that issue .	86	91	issue	0	1	1
3VCK0Q0PO5F5EA8F0OF7KEBFVK2N0K	In theory , a brown dwarf below 65 Jupiter masses is unable to burn lithium by thermonuclear fusion at any time during its evolution .	20	25	dwarf	0	1	1
3VCK0Q0PO5F5EA8F0OF7KEBFVK2N0K	In theory , a brown dwarf below 65 Jupiter masses is unable to burn lithium by thermonuclear fusion at any time during its evolution .	35	42	Jupiter	0	1	1
3VCK0Q0PO5F5EA8F0OF7KEBFVK2N0K	In theory , a brown dwarf below 65 Jupiter masses is unable to burn lithium by thermonuclear fusion at any time during its evolution .	43	49	masses	0	2	2
3VCK0Q0PO5F5EA8F0OF7KEBFVK2N0K	In theory , a brown dwarf below 65 Jupiter masses is unable to burn lithium by thermonuclear fusion at any time during its evolution .	68	75	lithium	1	0	1
3VCK0Q0PO5F5EA8F0OF7KEBFVK2N0K	In theory , a brown dwarf below 65 Jupiter masses is unable to burn lithium by thermonuclear fusion at any time during its evolution .	79	92	thermonuclear	5	5	10
3VCK0Q0PO5F5EA8F0OF7KEBFVK2N0K	In theory , a brown dwarf below 65 Jupiter masses is unable to burn lithium by thermonuclear fusion at any time during its evolution .	79	99	thermonuclear fusion	4	5	9
3VCK0Q0PO5F5EA8F0OF7KEBFVK2N0K	In theory , a brown dwarf below 65 Jupiter masses is unable to burn lithium by thermonuclear fusion at any time during its evolution .	93	99	fusion	4	2	6
3VCK0Q0PO5F5EA8F0OF7KEBFVK2N0K	In theory , a brown dwarf below 65 Jupiter masses is unable to burn lithium by thermonuclear fusion at any time during its evolution .	123	132	evolution	5	5	10
3W0KKJIARRAMOTSFYF06L10TKN9K8Z	Advaita ( literally , non-duality ) is a system of thought where `` Advaita '' refers to the identity of the Self ( Atman ) and the Whole ( Brahman ) .	0	7	Advaita	7	3	10
3W0KKJIARRAMOTSFYF06L10TKN9K8Z	Advaita ( literally , non-duality ) is a system of thought where `` Advaita '' refers to the identity of the Self ( Atman ) and the Whole ( Brahman ) .	10	19	literally	1	1	2
3W0KKJIARRAMOTSFYF06L10TKN9K8Z	Advaita ( literally , non-duality ) is a system of thought where `` Advaita '' refers to the identity of the Self ( Atman ) and the Whole ( Brahman ) .	10	33	literally , non-duality	1	0	1
3W0KKJIARRAMOTSFYF06L10TKN9K8Z	Advaita ( literally , non-duality ) is a system of thought where `` Advaita '' refers to the identity of the Self ( Atman ) and the Whole ( Brahman ) .	22	33	non-duality	5	8	13
3W0KKJIARRAMOTSFYF06L10TKN9K8Z	Advaita ( literally , non-duality ) is a system of thought where `` Advaita '' refers to the identity of the Self ( Atman ) and the Whole ( Brahman ) .	93	101	identity	1	1	2
3W0KKJIARRAMOTSFYF06L10TKN9K8Z	Advaita ( literally , non-duality ) is a system of thought where `` Advaita '' refers to the identity of the Self ( Atman ) and the Whole ( Brahman ) .	93	113	identity of the Self	1	0	1
3W0KKJIARRAMOTSFYF06L10TKN9K8Z	Advaita ( literally , non-duality ) is a system of thought where `` Advaita '' refers to the identity of the Self ( Atman ) and the Whole ( Brahman ) .	109	113	Self	0	2	2
3W0KKJIARRAMOTSFYF06L10TKN9K8Z	Advaita ( literally , non-duality ) is a system of thought where `` Advaita '' refers to the identity of the Self ( Atman ) and the Whole ( Brahman ) .	140	147	Brahman	1	0	1
3W0KKJIARRAMOTSFYF06L10TKN9K8Z	When Maya is removed , there exists ultimately no difference between the Jiva and Brahman ( Isvara ) .	5	9	Maya	0	1	1
3W0KKJIARRAMOTSFYF06L10TKN9K8Z	When Maya is removed , there exists ultimately no difference between the Jiva and Brahman ( Isvara ) .	13	20	removed	1	0	1
3W0KKJIARRAMOTSFYF06L10TKN9K8Z	When Maya is removed , there exists ultimately no difference between the Jiva and Brahman ( Isvara ) .	29	35	exists	2	0	2
3W0KKJIARRAMOTSFYF06L10TKN9K8Z	When Maya is removed , there exists ultimately no difference between the Jiva and Brahman ( Isvara ) .	36	46	ultimately	5	7	12
3W0KKJIARRAMOTSFYF06L10TKN9K8Z	When Maya is removed , there exists ultimately no difference between the Jiva and Brahman ( Isvara ) .	50	60	difference	1	0	1
3W0KKJIARRAMOTSFYF06L10TKN9K8Z	When Maya is removed , there exists ultimately no difference between the Jiva and Brahman ( Isvara ) .	73	77	Jiva	0	1	1
3W0KKJIARRAMOTSFYF06L10TKN9K8Z	Mahavakya , or `` the great sentences '' , state the unity of Brahman and Atman .	0	9	Mahavakya	2	2	4
3W0KKJIARRAMOTSFYF06L10TKN9K8Z	Mahavakya , or `` the great sentences '' , state the unity of Brahman and Atman .	28	37	sentences	1	0	1
3W0KKJIARRAMOTSFYF06L10TKN9K8Z	Mahavakya , or `` the great sentences '' , state the unity of Brahman and Atman .	53	58	unity	1	1	2
3W0KKJIARRAMOTSFYF06L10TKN9K8Z	Mahavakya , or `` the great sentences '' , state the unity of Brahman and Atman .	62	69	Brahman	1	0	1
3W0KKJIARRAMOTSFYF06L10TKN9K8Z	Mahavakya , or `` the great sentences '' , state the unity of Brahman and Atman .	62	79	Brahman and Atman	1	0	1
3W0KKJIARRAMOTSFYF06L10TKN9K8Z	Mahavakya , or `` the great sentences '' , state the unity of Brahman and Atman .	74	79	Atman	1	1	2
3W0KKJIARRAMOTSFYF06L10TKN9K8Z	According to Adi Shankara , God , the Supreme Cosmic Spirit or Brahman is the One , the whole and the only reality ( Paramarthika Satyam ) .	0	9	According	1	0	1
3W0KKJIARRAMOTSFYF06L10TKN9K8Z	According to Adi Shankara , God , the Supreme Cosmic Spirit or Brahman is the One , the whole and the only reality ( Paramarthika Satyam ) .	38	45	Supreme	0	1	1
3W0KKJIARRAMOTSFYF06L10TKN9K8Z	According to Adi Shankara , God , the Supreme Cosmic Spirit or Brahman is the One , the whole and the only reality ( Paramarthika Satyam ) .	38	59	Supreme Cosmic Spirit	1	3	4
3W0KKJIARRAMOTSFYF06L10TKN9K8Z	According to Adi Shankara , God , the Supreme Cosmic Spirit or Brahman is the One , the whole and the only reality ( Paramarthika Satyam ) .	38	70	Supreme Cosmic Spirit or Brahman	1	0	1
3W0KKJIARRAMOTSFYF06L10TKN9K8Z	According to Adi Shankara , God , the Supreme Cosmic Spirit or Brahman is the One , the whole and the only reality ( Paramarthika Satyam ) .	46	52	Cosmic	1	0	1
3W0KKJIARRAMOTSFYF06L10TKN9K8Z	According to Adi Shankara , God , the Supreme Cosmic Spirit or Brahman is the One , the whole and the only reality ( Paramarthika Satyam ) .	46	59	Cosmic Spirit	0	2	2
3W0KKJIARRAMOTSFYF06L10TKN9K8Z	According to Adi Shankara , God , the Supreme Cosmic Spirit or Brahman is the One , the whole and the only reality ( Paramarthika Satyam ) .	53	59	Spirit	0	1	1
3W0KKJIARRAMOTSFYF06L10TKN9K8Z	According to Adi Shankara , God , the Supreme Cosmic Spirit or Brahman is the One , the whole and the only reality ( Paramarthika Satyam ) .	63	70	Brahman	1	0	1
3W0KKJIARRAMOTSFYF06L10TKN9K8Z	According to Adi Shankara , God , the Supreme Cosmic Spirit or Brahman is the One , the whole and the only reality ( Paramarthika Satyam ) .	107	114	reality	2	3	5
3W0KKJIARRAMOTSFYF06L10TKN9K8Z	According to Adi Shankara , God , the Supreme Cosmic Spirit or Brahman is the One , the whole and the only reality ( Paramarthika Satyam ) .	117	129	Paramarthika	2	1	3
3W0KKJIARRAMOTSFYF06L10TKN9K8Z	According to Adi Shankara , God , the Supreme Cosmic Spirit or Brahman is the One , the whole and the only reality ( Paramarthika Satyam ) .	117	136	Paramarthika Satyam	1	0	1
3W0KKJIARRAMOTSFYF06L10TKN9K8Z	Perceptible feeling - many people , when they achieve the turīya state , claim that their soul has become one with everything else .	0	11	Perceptible	10	6	16
3W0KKJIARRAMOTSFYF06L10TKN9K8Z	Perceptible feeling - many people , when they achieve the turīya state , claim that their soul has become one with everything else .	0	19	Perceptible feeling	0	2	2
3W0KKJIARRAMOTSFYF06L10TKN9K8Z	Perceptible feeling - many people , when they achieve the turīya state , claim that their soul has become one with everything else .	46	53	achieve	1	3	4
3W0KKJIARRAMOTSFYF06L10TKN9K8Z	Perceptible feeling - many people , when they achieve the turīya state , claim that their soul has become one with everything else .	58	64	turīya	4	2	6
3W0KKJIARRAMOTSFYF06L10TKN9K8Z	Perceptible feeling - many people , when they achieve the turīya state , claim that their soul has become one with everything else .	58	70	turīya state	3	2	5
3W0KKJIARRAMOTSFYF06L10TKN9K8Z	Perceptible feeling - many people , when they achieve the turīya state , claim that their soul has become one with everything else .	73	78	claim	0	1	1
3W0KKJIARRAMOTSFYF06L10TKN9K8Z	Perceptible feeling - many people , when they achieve the turīya state , claim that their soul has become one with everything else .	90	94	soul	0	1	1
3W0KKJIARRAMOTSFYF06L10TKN9K8Z	Devotion ( Bhakti ) will cancel the effects of bad Karma and will bring a person closer to the true knowledge by purifying his mind .	0	8	Devotion	5	4	9
3W0KKJIARRAMOTSFYF06L10TKN9K8Z	Devotion ( Bhakti ) will cancel the effects of bad Karma and will bring a person closer to the true knowledge by purifying his mind .	47	56	bad Karma	1	0	1
3W0KKJIARRAMOTSFYF06L10TKN9K8Z	Devotion ( Bhakti ) will cancel the effects of bad Karma and will bring a person closer to the true knowledge by purifying his mind .	51	56	Karma	2	2	4
3W0KKJIARRAMOTSFYF06L10TKN9K8Z	Devotion ( Bhakti ) will cancel the effects of bad Karma and will bring a person closer to the true knowledge by purifying his mind .	66	71	bring	0	1	1
3W0KKJIARRAMOTSFYF06L10TKN9K8Z	Devotion ( Bhakti ) will cancel the effects of bad Karma and will bring a person closer to the true knowledge by purifying his mind .	100	109	knowledge	1	3	4
3W0KKJIARRAMOTSFYF06L10TKN9K8Z	Devotion ( Bhakti ) will cancel the effects of bad Karma and will bring a person closer to the true knowledge by purifying his mind .	113	122	purifying	7	8	15
3W0KKJIARRAMOTSFYF06L10TKN9K8Z	Devotion ( Bhakti ) will cancel the effects of bad Karma and will bring a person closer to the true knowledge by purifying his mind .	127	131	mind	0	1	1
3NFWQRSHVEFQ1M6JG2LXX1PM0A5FG8	Toronto traded Stewart to Chicago early in the 1947-48 season in a deal that brought Max Bentley to the Leafs .	8	14	traded	1	4	5
3NFWQRSHVEFQ1M6JG2LXX1PM0A5FG8	Toronto traded Stewart to Chicago early in the 1947-48 season in a deal that brought Max Bentley to the Leafs .	55	61	season	0	1	1
3NFWQRSHVEFQ1M6JG2LXX1PM0A5FG8	Toronto traded Stewart to Chicago early in the 1947-48 season in a deal that brought Max Bentley to the Leafs .	77	84	brought	0	2	2
3NFWQRSHVEFQ1M6JG2LXX1PM0A5FG8	Toronto traded Stewart to Chicago early in the 1947-48 season in a deal that brought Max Bentley to the Leafs .	89	96	Bentley	0	1	1
3NFWQRSHVEFQ1M6JG2LXX1PM0A5FG8	Toronto traded Stewart to Chicago early in the 1947-48 season in a deal that brought Max Bentley to the Leafs .	104	109	Leafs	2	1	3
3NFWQRSHVEFQ1M6JG2LXX1PM0A5FG8	His use of Russian language formed the basis of the style of novelists Ivan Turgenev , Ivan Goncharov , and Leo Tolstoy , as well as that of subsequent lyric poets such as Mikhail Lermontov .	39	44	basis	1	0	1
3NFWQRSHVEFQ1M6JG2LXX1PM0A5FG8	His use of Russian language formed the basis of the style of novelists Ivan Turgenev , Ivan Goncharov , and Leo Tolstoy , as well as that of subsequent lyric poets such as Mikhail Lermontov .	39	57	basis of the style	1	0	1
3NFWQRSHVEFQ1M6JG2LXX1PM0A5FG8	His use of Russian language formed the basis of the style of novelists Ivan Turgenev , Ivan Goncharov , and Leo Tolstoy , as well as that of subsequent lyric poets such as Mikhail Lermontov .	61	70	novelists	7	3	10
3NFWQRSHVEFQ1M6JG2LXX1PM0A5FG8	His use of Russian language formed the basis of the style of novelists Ivan Turgenev , Ivan Goncharov , and Leo Tolstoy , as well as that of subsequent lyric poets such as Mikhail Lermontov .	76	84	Turgenev	1	0	1
3NFWQRSHVEFQ1M6JG2LXX1PM0A5FG8	His use of Russian language formed the basis of the style of novelists Ivan Turgenev , Ivan Goncharov , and Leo Tolstoy , as well as that of subsequent lyric poets such as Mikhail Lermontov .	92	101	Goncharov	1	0	1
3NFWQRSHVEFQ1M6JG2LXX1PM0A5FG8	His use of Russian language formed the basis of the style of novelists Ivan Turgenev , Ivan Goncharov , and Leo Tolstoy , as well as that of subsequent lyric poets such as Mikhail Lermontov .	108	119	Leo Tolstoy	1	0	1
3NFWQRSHVEFQ1M6JG2LXX1PM0A5FG8	His use of Russian language formed the basis of the style of novelists Ivan Turgenev , Ivan Goncharov , and Leo Tolstoy , as well as that of subsequent lyric poets such as Mikhail Lermontov .	141	151	subsequent	10	6	16
3NFWQRSHVEFQ1M6JG2LXX1PM0A5FG8	His use of Russian language formed the basis of the style of novelists Ivan Turgenev , Ivan Goncharov , and Leo Tolstoy , as well as that of subsequent lyric poets such as Mikhail Lermontov .	152	157	lyric	1	3	4
3NFWQRSHVEFQ1M6JG2LXX1PM0A5FG8	His use of Russian language formed the basis of the style of novelists Ivan Turgenev , Ivan Goncharov , and Leo Tolstoy , as well as that of subsequent lyric poets such as Mikhail Lermontov .	152	163	lyric poets	1	1	2
3NFWQRSHVEFQ1M6JG2LXX1PM0A5FG8	His use of Russian language formed the basis of the style of novelists Ivan Turgenev , Ivan Goncharov , and Leo Tolstoy , as well as that of subsequent lyric poets such as Mikhail Lermontov .	180	189	Lermontov	1	0	1
3NFWQRSHVEFQ1M6JG2LXX1PM0A5FG8	Vertical distance measurements in the `` down '' direction are commonly referred to as depth .	0	8	Vertical	4	3	7
3NFWQRSHVEFQ1M6JG2LXX1PM0A5FG8	Vertical distance measurements in the `` down '' direction are commonly referred to as depth .	0	17	Vertical distance	1	1	2
3NFWQRSHVEFQ1M6JG2LXX1PM0A5FG8	Vertical distance measurements in the `` down '' direction are commonly referred to as depth .	18	30	measurements	1	1	2
3NFWQRSHVEFQ1M6JG2LXX1PM0A5FG8	Vertical distance measurements in the `` down '' direction are commonly referred to as depth .	72	80	referred	0	2	2
3NFWQRSHVEFQ1M6JG2LXX1PM0A5FG8	Vertical distance measurements in the `` down '' direction are commonly referred to as depth .	72	83	referred to	1	0	1
3NFWQRSHVEFQ1M6JG2LXX1PM0A5FG8	Vertical distance measurements in the `` down '' direction are commonly referred to as depth .	87	92	depth	0	4	4
3NFWQRSHVEFQ1M6JG2LXX1PM0A5FG8	However , people living at higher elevations have a statistically significant higher rate of suicide .	34	44	elevations	5	7	12
3NFWQRSHVEFQ1M6JG2LXX1PM0A5FG8	However , people living at higher elevations have a statistically significant higher rate of suicide .	52	65	statistically	6	4	10
3NFWQRSHVEFQ1M6JG2LXX1PM0A5FG8	However , people living at higher elevations have a statistically significant higher rate of suicide .	52	77	statistically significant	3	2	5
3NFWQRSHVEFQ1M6JG2LXX1PM0A5FG8	However , people living at higher elevations have a statistically significant higher rate of suicide .	66	77	significant	1	2	3
3NFWQRSHVEFQ1M6JG2LXX1PM0A5FG8	However , people living at higher elevations have a statistically significant higher rate of suicide .	85	89	rate	0	2	2
3NFWQRSHVEFQ1M6JG2LXX1PM0A5FG8	However , people living at higher elevations have a statistically significant higher rate of suicide .	93	100	suicide	3	1	4
3NFWQRSHVEFQ1M6JG2LXX1PM0A5FG8	The lack of oxygen above 2,400 metres ( 8,000 ft ) can cause serious illnesses such as altitude sickness , high altitude pulmonary edema , and high altitude cerebral edema .	4	8	lack	0	2	2
3NFWQRSHVEFQ1M6JG2LXX1PM0A5FG8	The lack of oxygen above 2,400 metres ( 8,000 ft ) can cause serious illnesses such as altitude sickness , high altitude pulmonary edema , and high altitude cerebral edema .	12	18	oxygen	1	0	1
3NFWQRSHVEFQ1M6JG2LXX1PM0A5FG8	The lack of oxygen above 2,400 metres ( 8,000 ft ) can cause serious illnesses such as altitude sickness , high altitude pulmonary edema , and high altitude cerebral edema .	31	37	metres	1	0	1
3NFWQRSHVEFQ1M6JG2LXX1PM0A5FG8	The lack of oxygen above 2,400 metres ( 8,000 ft ) can cause serious illnesses such as altitude sickness , high altitude pulmonary edema , and high altitude cerebral edema .	69	78	illnesses	0	2	2
3NFWQRSHVEFQ1M6JG2LXX1PM0A5FG8	The lack of oxygen above 2,400 metres ( 8,000 ft ) can cause serious illnesses such as altitude sickness , high altitude pulmonary edema , and high altitude cerebral edema .	87	95	altitude	3	4	7
3NFWQRSHVEFQ1M6JG2LXX1PM0A5FG8	The lack of oxygen above 2,400 metres ( 8,000 ft ) can cause serious illnesses such as altitude sickness , high altitude pulmonary edema , and high altitude cerebral edema .	87	104	altitude sickness	2	2	4
3NFWQRSHVEFQ1M6JG2LXX1PM0A5FG8	The lack of oxygen above 2,400 metres ( 8,000 ft ) can cause serious illnesses such as altitude sickness , high altitude pulmonary edema , and high altitude cerebral edema .	96	104	sickness	0	3	3
3NFWQRSHVEFQ1M6JG2LXX1PM0A5FG8	The lack of oxygen above 2,400 metres ( 8,000 ft ) can cause serious illnesses such as altitude sickness , high altitude pulmonary edema , and high altitude cerebral edema .	107	136	high altitude pulmonary edema	2	0	2
3NFWQRSHVEFQ1M6JG2LXX1PM0A5FG8	The lack of oxygen above 2,400 metres ( 8,000 ft ) can cause serious illnesses such as altitude sickness , high altitude pulmonary edema , and high altitude cerebral edema .	112	130	altitude pulmonary	1	0	1
3NFWQRSHVEFQ1M6JG2LXX1PM0A5FG8	The lack of oxygen above 2,400 metres ( 8,000 ft ) can cause serious illnesses such as altitude sickness , high altitude pulmonary edema , and high altitude cerebral edema .	121	130	pulmonary	1	2	3
3NFWQRSHVEFQ1M6JG2LXX1PM0A5FG8	The lack of oxygen above 2,400 metres ( 8,000 ft ) can cause serious illnesses such as altitude sickness , high altitude pulmonary edema , and high altitude cerebral edema .	121	136	pulmonary edema	8	4	12
3NFWQRSHVEFQ1M6JG2LXX1PM0A5FG8	The lack of oxygen above 2,400 metres ( 8,000 ft ) can cause serious illnesses such as altitude sickness , high altitude pulmonary edema , and high altitude cerebral edema .	131	136	edema	1	1	2
3NFWQRSHVEFQ1M6JG2LXX1PM0A5FG8	The lack of oxygen above 2,400 metres ( 8,000 ft ) can cause serious illnesses such as altitude sickness , high altitude pulmonary edema , and high altitude cerebral edema .	143	171	high altitude cerebral edema	2	0	2
3NFWQRSHVEFQ1M6JG2LXX1PM0A5FG8	The lack of oxygen above 2,400 metres ( 8,000 ft ) can cause serious illnesses such as altitude sickness , high altitude pulmonary edema , and high altitude cerebral edema .	157	165	cerebral	3	0	3
3NFWQRSHVEFQ1M6JG2LXX1PM0A5FG8	The lack of oxygen above 2,400 metres ( 8,000 ft ) can cause serious illnesses such as altitude sickness , high altitude pulmonary edema , and high altitude cerebral edema .	157	171	cerebral edema	7	4	11
3NFWQRSHVEFQ1M6JG2LXX1PM0A5FG8	The lack of oxygen above 2,400 metres ( 8,000 ft ) can cause serious illnesses such as altitude sickness , high altitude pulmonary edema , and high altitude cerebral edema .	166	171	edema	1	0	1
3NFWQRSHVEFQ1M6JG2LXX1PM0A5FG8	High altitude is sometimes defined to begin at 2,400 metres ( 8,000 ft ) above sea level .	5	13	altitude	2	0	2
3NFWQRSHVEFQ1M6JG2LXX1PM0A5FG8	High altitude is sometimes defined to begin at 2,400 metres ( 8,000 ft ) above sea level .	27	34	defined	1	1	2
3E22YV8GG1782RCZH9UXZFCN3SEPNT	With a population of 2,239,191 according to the last census ( 2010 ) , Quito is the second most populous city in Ecuador , after Guayaquil .	7	17	population	2	2	4
3E22YV8GG1782RCZH9UXZFCN3SEPNT	With a population of 2,239,191 according to the last census ( 2010 ) , Quito is the second most populous city in Ecuador , after Guayaquil .	53	59	census	10	4	14
3E22YV8GG1782RCZH9UXZFCN3SEPNT	With a population of 2,239,191 according to the last census ( 2010 ) , Quito is the second most populous city in Ecuador , after Guayaquil .	84	104	second most populous	1	0	1
3E22YV8GG1782RCZH9UXZFCN3SEPNT	With a population of 2,239,191 according to the last census ( 2010 ) , Quito is the second most populous city in Ecuador , after Guayaquil .	96	104	populous	10	5	15
3E22YV8GG1782RCZH9UXZFCN3SEPNT	Quito ( Spanish pronunciation : ( ˈkito ) ) , formally San Francisco de Quito , is the capital city of Ecuador , and at an elevation of 9,350 feet ( 2,800 meters above sea level ) , it is the highest official capital city in the world .	0	5	Quito	1	0	1
3E22YV8GG1782RCZH9UXZFCN3SEPNT	Quito ( Spanish pronunciation : ( ˈkito ) ) , formally San Francisco de Quito , is the capital city of Ecuador , and at an elevation of 9,350 feet ( 2,800 meters above sea level ) , it is the highest official capital city in the world .	16	29	pronunciation	5	2	7
3E22YV8GG1782RCZH9UXZFCN3SEPNT	Quito ( Spanish pronunciation : ( ˈkito ) ) , formally San Francisco de Quito , is the capital city of Ecuador , and at an elevation of 9,350 feet ( 2,800 meters above sea level ) , it is the highest official capital city in the world .	46	54	formally	3	0	3
3E22YV8GG1782RCZH9UXZFCN3SEPNT	Quito ( Spanish pronunciation : ( ˈkito ) ) , formally San Francisco de Quito , is the capital city of Ecuador , and at an elevation of 9,350 feet ( 2,800 meters above sea level ) , it is the highest official capital city in the world .	87	94	capital	1	0	1
3E22YV8GG1782RCZH9UXZFCN3SEPNT	Quito ( Spanish pronunciation : ( ˈkito ) ) , formally San Francisco de Quito , is the capital city of Ecuador , and at an elevation of 9,350 feet ( 2,800 meters above sea level ) , it is the highest official capital city in the world .	123	132	elevation	8	7	15
3E22YV8GG1782RCZH9UXZFCN3SEPNT	Quito ( Spanish pronunciation : ( ˈkito ) ) , formally San Francisco de Quito , is the capital city of Ecuador , and at an elevation of 9,350 feet ( 2,800 meters above sea level ) , it is the highest official capital city in the world .	168	177	sea level	0	1	1
3E22YV8GG1782RCZH9UXZFCN3SEPNT	Quito ( Spanish pronunciation : ( ˈkito ) ) , formally San Francisco de Quito , is the capital city of Ecuador , and at an elevation of 9,350 feet ( 2,800 meters above sea level ) , it is the highest official capital city in the world .	200	208	official	1	1	2
3E22YV8GG1782RCZH9UXZFCN3SEPNT	In all countries , it is the responsibility of the mother 's physician , midwife , hospital administrator , or the parents of the child to see that the birth is properly registered with the appropriate government agency .	29	43	responsibility	2	1	3
3E22YV8GG1782RCZH9UXZFCN3SEPNT	In all countries , it is the responsibility of the mother 's physician , midwife , hospital administrator , or the parents of the child to see that the birth is properly registered with the appropriate government agency .	61	70	physician	6	5	11
3E22YV8GG1782RCZH9UXZFCN3SEPNT	In all countries , it is the responsibility of the mother 's physician , midwife , hospital administrator , or the parents of the child to see that the birth is properly registered with the appropriate government agency .	61	105	physician , midwife , hospital administrator	1	0	1
3E22YV8GG1782RCZH9UXZFCN3SEPNT	In all countries , it is the responsibility of the mother 's physician , midwife , hospital administrator , or the parents of the child to see that the birth is properly registered with the appropriate government agency .	73	80	midwife	7	8	15
3E22YV8GG1782RCZH9UXZFCN3SEPNT	In all countries , it is the responsibility of the mother 's physician , midwife , hospital administrator , or the parents of the child to see that the birth is properly registered with the appropriate government agency .	83	105	hospital administrator	2	1	3
3E22YV8GG1782RCZH9UXZFCN3SEPNT	In all countries , it is the responsibility of the mother 's physician , midwife , hospital administrator , or the parents of the child to see that the birth is properly registered with the appropriate government agency .	92	105	administrator	2	3	5
3E22YV8GG1782RCZH9UXZFCN3SEPNT	In all countries , it is the responsibility of the mother 's physician , midwife , hospital administrator , or the parents of the child to see that the birth is properly registered with the appropriate government agency .	152	157	birth	0	1	1
3E22YV8GG1782RCZH9UXZFCN3SEPNT	In all countries , it is the responsibility of the mother 's physician , midwife , hospital administrator , or the parents of the child to see that the birth is properly registered with the appropriate government agency .	161	169	properly	1	3	4
3E22YV8GG1782RCZH9UXZFCN3SEPNT	In all countries , it is the responsibility of the mother 's physician , midwife , hospital administrator , or the parents of the child to see that the birth is properly registered with the appropriate government agency .	161	180	properly registered	1	0	1
3E22YV8GG1782RCZH9UXZFCN3SEPNT	In all countries , it is the responsibility of the mother 's physician , midwife , hospital administrator , or the parents of the child to see that the birth is properly registered with the appropriate government agency .	170	180	registered	2	2	4
3E22YV8GG1782RCZH9UXZFCN3SEPNT	In all countries , it is the responsibility of the mother 's physician , midwife , hospital administrator , or the parents of the child to see that the birth is properly registered with the appropriate government agency .	190	201	appropriate	8	4	12
3E22YV8GG1782RCZH9UXZFCN3SEPNT	In all countries , it is the responsibility of the mother 's physician , midwife , hospital administrator , or the parents of the child to see that the birth is properly registered with the appropriate government agency .	190	212	appropriate government	1	2	3
3E22YV8GG1782RCZH9UXZFCN3SEPNT	In all countries , it is the responsibility of the mother 's physician , midwife , hospital administrator , or the parents of the child to see that the birth is properly registered with the appropriate government agency .	213	219	agency	2	0	2
3E22YV8GG1782RCZH9UXZFCN3SEPNT	The statue was moved to the Accademia Gallery in Florence in 1873 , and later replaced at the original location by a replica .	4	10	statue	3	0	3
3E22YV8GG1782RCZH9UXZFCN3SEPNT	The statue was moved to the Accademia Gallery in Florence in 1873 , and later replaced at the original location by a replica .	28	37	Accademia	1	1	2
3E22YV8GG1782RCZH9UXZFCN3SEPNT	The statue was moved to the Accademia Gallery in Florence in 1873 , and later replaced at the original location by a replica .	78	86	replaced	1	1	2
3E22YV8GG1782RCZH9UXZFCN3SEPNT	The statue was moved to the Accademia Gallery in Florence in 1873 , and later replaced at the original location by a replica .	94	102	original	2	0	2
3E22YV8GG1782RCZH9UXZFCN3SEPNT	The statue was moved to the Accademia Gallery in Florence in 1873 , and later replaced at the original location by a replica .	117	124	replica	10	7	17
